10yard	10ヤードファイト	てんやーどふぁいと
1941	1941 - カウンターアタック	いちきゅうよん_4
1942	1942	いちきゅうよん_1
1943	1943 - ミッドウェイ海戦	いちきゅうよん_2
1943kai	1943改 - ミッドウェイ海戦	いちきゅうよん_3
1944	1944 - ザ・ループマスター	いちきゅうよん_5
19xx	19XX - THE WAR AGAINST DESTINY	ないんてぃーんだぶるえっくす
2020bb	2020年スーパーベースボール	にせんにじゅうねんすーぱーべーすぼーる
32x_knuk	カオティクス / Knuckles Chaotix (スーパー32X)	かおてぃくす_s
3countb	ファイヤー・スープレックス	ふぁいやーすーぷれっくす
3wonders	ワンダー3	わんだーすりー
40love	40-0 ＜フォーティラブ＞	ふぉーてぃーらぶ
47pie2	アイドル雀士スーチーパイII (v1.1)	あいどるじゃんしすーちーぱい2
4dwarrio	4-Dウォーリアーズ	ふぉーでぃーうぉーりあーず
500gp	500GP	ごひゃくじーぴー
64street	64番街	ろくじゅうよんばんがい
720	720°	せぶんとぅえんてぃでぃぐりーず
7ordi	7 Ordi (韓国版)	せぶんおるでぃ
88games	ハイパースポーツスペシャル	はいぱーすぽーつすぺしゃる
aar_101	アーロンスペリング (ピンボール)	あーろんすぺりんぐ
abcop	A.B.コップ	えあーばいくこっぷ
aburner	アフターバーナー	あふたーばーなー1
aburner2	アフターバーナーII	あふたーばーなー2
aceattaca	エースアタッカー (日本版, System 16A, FD1094 317-0060)	えーすあたっかー
aceattac	エースアタッカー	えーすあたっかー
acedrvrw	エースドライバー	えーすどらいばー
actfancr	アクトフェンサー	あくとふぇんさー
aerofgt	ソニックウイングス	そにっくうぃんぐす
afighter	アクションファイター	あくしょんふぁいたー
afm_113	アタックフロムマーズ (ピンボール)	あったくふろむまーず
afv_l4	アダムスファミリーバリューズ (Coin Dropper, L-4) (ピンボール)	あだむすふぁみりーp2
agallet	アクウギャレット / Air Gallet	あくうぎゃれっと
agress	アグレス - ミサイル大戦略	あぐれす
ainferno	エアーインフェルノ	えあーいんふぇるの
airbustrb	エアバスター (海賊版)	えあばすたー__b
airbustr	エアバスター	えあばすたー
airco22b	エアーコンバット22	えあーこんばっと2
aircomb	エアーコンバット	えあーこんばっと1
airduel	エアデュエル	えあでゅえる
ajax	A-JAX / Typhoon (海外版)	えーじゃっくす_w
ajaxj	A-JAX (日本版)	えーじゃっくす_j
akiss	麻雀エンジェルキッス	まーじゃんえんじぇるきっす
alexkidd	アレックスキッド - ロストスターズ	あれっくすきっどろすとすたーず
alien3	エイリアン3 ザ・ガン	えいりあん3
aliens	エイリアンズ	えいりあんず
aliensec	バラデューク / Alien Sector	ばらでゅーく
aliensyn2	エイリアンシンドローム (System 16A)	えいりあんしんどろーむa
aliensyn	エイリアンシンドローム (System 16B)	えいりあんしんどろーむb
alpha1v	Alpha One (Vision Electronics / Kyle Hodgetts)	あるふぁわん
alpham2	ASO II - ラストガーディアン	えーえすおー2
alpham2p	ASO II - ラストガーディアン (プロタイプ)	えーえすおー2p
alpine	アルペンスキー	あるぺんすきー
alpinerd	アルペンレーサー	あるぺんれーさー1
alpinesa	アルペンサーファー	あるぺんさーふぁー
alpinr2b	アルペンレーサー2	あるぺんれーさー2
altbeast	獣王記 / Alterd Beast	じゅうおうき
amazon	聖戦士アマテラス / Soldier Girl Amazon	せいせいんしあまてらす
amidar	アミダー	あみだー
andretti	マリオ・アンドレッティ (ピンボール)	まりおあんどれってぃ
androdun	アンドロデュノス	あんどろでゅのす
anteater	Anteater	あんといーたー
aodk	痛快GANGAN行進曲 / Aggressors of Dark Kombat	つうかいがんがんこうしんきょく
aof	龍虎の拳 / Art of Fighting	りゅうこのけん1
aof2	龍虎の拳2 / Art of Fighting 2	りゅうこのけん2
aof3	アートオブファイティング 龍虎の拳外伝 / Art of Fighting 3	あーとおぶふぁいてぃんぐ
apb	オールポインツバレッティン	おーるぽいんつばれってぃん
apollo13	アポロ13 (ピンボール)	あぽろさーてぃーん
aquajack	アクアジャック	あくあじゃっく
aquarium	アクアリウム	あくありうむ
aquarush	アクアラッシュ	あくあらっしゅ
arabfgt	アラビアンファイト	あらびあんふぁいと
arabianm	アラビアンマジック	あらびあんまじっく
archrivl	Arch Rivals	あーちらいんばるず
arescue	エアレスキュー	えあれすきゅー
argus	アーガス	あーがす
arkanoid	アルカノイド (海外版)	あるかのいど_w
arkarea	アークエリア	あーくえりあ
arknoid2j	アルカノイド - リベンジオブDOH (日本版)	あるかのいどりべんじおぶどー_j
arknoid2u	アルカノイド - リベンジオブDOH (US版)	あるかのいどりべんじおぶどー_u
arknoid2	アルカノイド - リベンジオブDOH	あるかのいどりべんじおぶどー_w
arkretrn	アルカノイドリターンズ	あるかのいどりたーんず
armedf	アームドF	あーむどふぉーめーしょん
armorcar	Armored Car	あーまーどかー
armwar	パワードギア	ぱわーどぎあ
ashura	阿修羅ブラスター	あしゅらぶらすたー
assault	アサルト	あさると
asterix	アステリクス	あすてりくす
astorm	エイリアンストーム	えいりあんすとーむ
astyanax	ザ・ロード・オブ・キング / The Astyanax	ざろーどおぶきんぐ
asuka	飛鳥＆飛鳥	あすかあんどあすか
asurabld	アシュラブレード	あしゅらぶれーど
asurabus	アシュラバスター	あしゅらばすたー
athena	アテナ	あてな
atlantisp	アトランティス (ピンボール)	あとらんてぃすp
aurail	オーライル	おーらいる
avengers	必殺！無頼拳 / Avengers	ひっさつぶらいけん
avsp	エイリアン VS プレデター	えいりあんばーさすぷれでたー
avspirit	ファンタズム / Avenging Spirit	ふぁんたずむ
baddudes	ドラゴン忍者 / Bad Dudes vs. Dragonninja	どらごんにんじゃ
badlands	Bad Lands	ばっどらんず
bakatono	バカ殿様麻雀漫遊記	ばかとのさままーじゃんまんゆうき
bakutotu	爆突機銃艇	ばくとつきじゅうてい
bangbead	バンビード	ばんびーど
barbwire	バーブワイヤ (ピンボール)	ばーぶわいや
bass	ゲットバス	げっとばす
batcir	バトルサーキット	ばとるさーきっと
batman	Batman	ばっとまん
batmanf	バットマンフォーエバー (ピンボール, ver 4.0)	ばっとまんふぉーえばー
batrider	アームドポリス バトライダー	あーむどぽりすばとらいだー
battlnts	バトランティス	ばとらんてぃす
battroad	ザ・バトルロード	ざばとるろーど
bayroute	ベイルート	べいるーと
baywatch	ベイウォッチ (ピンボール)	べいうぉっち
bbbxing	ベストバウトボクシング	べすとばうとぼくしんぐ
bbmanw	ボンバーマンワールド	ぼんばーまんわーるど
bbnny_l2	バッグス・バニーズ・バースデー・バッシュ (ピンボール)	ばっぐすばにーずばーすでーばっしゅ
bbusters	ビーストバスターズ	びーすとばすたーず
bcats_l5	バッドキャッツ (L-5) (ピンボール)	ばっどきゃっつp
bchopper	Mr.HELIの大冒険 / Battle Chopper (海外版)	みすたーへりのだいぼうけん_w
beastrzr	ブラッディロア - ハイパービーストデュエル	ぶらっでぃろあ1
beathead	BeatHead (プロトタイプ)	びーとへっど
bel	ビハインドエネミーラインズ	びはいんどえねみーらいんず
bellring	ベルリンガー (ピンボール)	べるりんがー
benberob	べんべろべえ	べんべろべえ
berabohm	超絶倫人ベラボーマン	ちょうぜつりんじんべらぼーまん
bermudat	バミューダトライアングル	ばみゅーだとらいあんぐる
bgaregga	バトルガレッガ	ばとるがれっが
bguns_l8	ビッグガンズ (L-8) (ピンボール)	びっぐがんずp
bigfight	ビッグファイト	びっぐふぁいと
bighurt	ビッグハート (ピンボール)	びっぐはーと
bigrun	ビッグラン	びっぐらん
bigstrik	ビッグストライカー	びっぐすとらいかー
bioatack	バイオアタック	ばいおあたっく
bionicc	トップシークレット / Bionic Commando	とっぷしーくれっと
birdtry	バーディートライ	ばーでぃーとらいい
bjourney	ラギ / Blue's Journey	らぎ
bk2k_l4	ブラックナイト2000 (L-4) (ピンボール)	ぶらっくないと2000p
bbakraid	バトルバクレイド	ばとるばくれいど
bkrtmaq	爆裂クイズ魔Q大冒険	ばくれつくいずまきゅーだいぼうけん
bladestl	Blades of Steel	ぶれーずおぶすてぃーる
blastoff	ブラストオフ	ぶらすとおふ
blazer	ブレイザー	ぶれいざー
blazstar	ブレイジングスター	ぶれいじんぐすたー
bldyror2	ブラッディロア2 - ブリンガーオブザニューエイジ	ぶらっでぃろあ2
blkpnthr	ブラックパンサー	ぶらっくぱんさー
blktiger	ブラックドラゴン / Black Tiger	ぶらっくどらごん
block	ブロックブロック	ぶろっくぶろっく
blockgal	ブロックギャル	ぶろっくぎゃる
blockhl	クォース / Block Hole	くぉーす
blockout	ブロックアウト	ぶろっくあうと
bloodbro	ブラッドブラザーズ	ぶらっどぶらざーず
bloodstm	Blood Storm	ぶらっどすとーむ
bloxeed	ブロクシード	ぶろくしーど
blstroid	ブラステロイド	ぶらすてろいど
blswhstl	出たな!!ツインビー / Bells＆Whistles	でたなついんびー
blzntrnd	ブレイジングトルネード	ぶれいじんぐとるねーど
bmaster	クロスブレイズ / Blade Master	くろすぶれいず
bnzai_l3	バンザイラン (L-3) (ピンボール)	ばんざいらんp
bodyslam	ダンプ松本 / Body Slam (海外版)	だんぷまつもと
bombjack	ボンジャック	ぼんじゃっく
bombsa	Bombs Away	ぼむずあうぇい
bonzeadv	地獄めぐり / Bonze Adventure	じごくめぐり
boogwing	ザ・グレイトラグタイムショー / Boogie Wings	ざぐれーとらぐたいむしょー
bosco	ボスコニアン (new version)	ぼすこにあん
bottom9	メインスタジアム / Bottom of the Ninth	めいんすたじあむ
bouldash	バルダーダッシュ	ばるだーだっしゅ
boxyboy	倉庫番デラックス / Boxy Boy	そうこばんでらっくす
brain	ブレイン	ぶれいん
breakers	ブレイカーズ	ぶれいかーず
breakrev	ブレイカーズリベンジ	ぶれいかーずりべんじ
brival	バーニングライバル	ばーにんぐらいばる
brvblade	ブレイブブレイド	ぶれいぶぶれいど
bssoccer	Back Street Soccer	ばっくすとりーとさっかー
bstars	ベースボールスターズプロフェッショナル	べーすぼーるすたーず1
bstars2	ベースボールスターズ2	べーすぼーるすたーず2
btime	バーガータイム (Data East)	ばーがーたいむ
btlkroad	バトルクロード	ばとるくろーど
btmn_103	バットマン (1.03) (ピンボール)	ばっとまんp
btoads	BattleToads	ばとるとーず
bubblem	バブルメモリーズ - THE STORY OF BUBLLE BOBBLE III	ばぶるめもりーず
bubbletr	バブルトラブル - ゴーリーゴースト2	ばぶるとらぶる
bublbob2	バブルシンフォニー / Bubble Bobble II	ばぶるしんふぉにー
bublbobl	バブルボブル	ばぶるぼぶる
bubsys	バブルシステムBIOS	ばぶるしすてむ
bucky	バッキーオヘア	ばっきーおへあ
buggyboyjr	バギーボーイ / Speed Buggy	ばぎーぼーい
bullet	バレット	ばれっと
bullfgt	ザ・闘牛 / Bullfight	ざとうぎゅう
bullfgtr	ブルファイター	ぶるふぁいたー
burnforc	バーニングフォース	ばーにんぐふぉーす
burningf	バーニングファイト	ばーにんぐふぁいと
burningfp	バーニングファイト (プロトタイプ)	ばーにんぐふぁいとp
butasan	ぶたさん	ぶたさん
ironclad	超鉄ブリキンガー (プロトタイプ)	ちょうてつぶりきんがーp
cactjack	カクタスジャック (ピンボール)	かくたすじゃっく
cadash	カダッシュ	かだっしゅ
calipso	Calipso	かりゅぷそ
cameltry	キャメルトライ (US版, YM2610)	きゃめるとらい
cameltrya	キャメルトライ (海外版, YM2203 + M6295)	きゃめるとらい
captaven	キャプテンアメリカ - ジ・アベンジャーズ	きゃぷてんあめりか
captcomm	キャプテンコマンドー	きゃぷてんこまんどー
carhop	カーホップ (ピンボール)	かーほっぷ
cavelon	Cavelon	けいぶろん
cawing	U.S.ネイビー / Carrier Air Wing	ゆーえすねいびー
cbombers	チェイスボンバーズ	ちぇいすぼんばーず
cbuster	クルードバスター	くるーどばすたー
cc_13	カクタスキャニオン (ピンボール)	かくたすきゃにおん
cclimbr2	クレイジークライマー2	くれいじーくらいまー2
ccruise	カリビアンクルーズ (ピンボール)	かりびあんくるーず
cgangpzl	コズモギャング・ザ・パズル	こずもぎゃんぐざぱずる
champwr	チャンピオンレスラー	ちゃんぴおんれすらー
chasehq	チェイスH.Q (海外版)	ちぇいすえいちきゅー
chasehqj	チェイスH.Q (日本版)	ちぇいすえいちきゅー
chelnov	チェルノブ - 戦う人間発電所	ちぇるのぶ
chimerab	キメラビースト	きめらびーすと
chinagat	西遊降魔録 - 流棒妖技ノ章	さいゆうごうまろく
chinatwn	チャイナタウン	ちゃいなたうん
choko	長江	ちょうこう
choplift	チョップリフター	ちょっぷりふたー
chopper	航空騎兵物語 / Chopper I	こうくうきへいものがたり
chqflag	チェッカーフラグ	ちぇっかーふらぐ
circusc	サーカスチャーリー	さーかすちゃーりー
cischeat	シスコヒート	しすこひーと
citybomb	シティーボンバー	してぃーぼんばー
citycon	シティコネクション	してぃこねくしょｎ
ckongs	クレイジーコング (スクランブル基板)	くれいじーこんぐ
clas1812	クラスオブ1812 (ピンボール)	くらすおぶえいてぃーんとぅえるぶ
cleopatr	クレオパトラフォーチュン	くれおぱとらふぉーちゅん
cltchitr	クラッチヒッター	くらっちひったー
cninja	戦え原始人 ジョー＆マック	たたかえげんしじん
cobracom	コブラコマンドー	こぶらこまんどー
combatsc	コンバットスクール	こんばっとすくーる
commando	戦場の狼	せんじょうのおおかみ
congo_21	コンゴ (ピンボール)	こんご
contcirc	コンチネンタルサーカス	こんちねんたるさーかす
contra	魂斗羅	こんとら
corv_21	コルベット (ピンボール)	こるべっと
cosmccop	ギャロップ / Cosmic Cop	ぎゃろっぷ
cosmogng	コズモギャング・ザ・ビデオ (海外版)	こずもぎゃんぐざびでお_w
cosmogngj	コズモギャング・ザ・ビデオ (日本版)	こずもぎゃんぐざびでお_j
cotton	コットン (海外版)	こっとん_w
cottonj	コットン (日本版)	こっとん_j
countryc	カントリークラブ	かんとりーくらぶ
cp_16	チャンピオンシップパブ (ピンボール)	ちゃんぴおんしっぷぱぶ
crater	Crater Raider	くれいたーらいだー
crimec	クライムシティ	くらいむしてぃ
crimfght	クライムファイターズ	くらいむふぁいたーず
crshrace	爆裂クラッシュレース	ばくれつくらっしゅれーす
crsword	クロスソード	くろすそーど
crusnusa	クルージンUSA	くるーじんゆーえすえー
crusnwld	クルージンワールド	くるーじんわーるど
csclub	カプコンスポーツクラブ	かぷこんすぽーつくらぶ
csprint	チャンピオンシップスプリント	ちゃんぴおんしっぷすぷりんと
ctomaday	キャプテントマディー	きゃぷてんとまでぃ
ctribe	ザ・コンバットライブス	ざこんばっとらいぶす
cueball	キューボールウィザード (ピンボール)	きゅーぼーるうぃざーど
cuebrickj	キューブリック	きゅーぶりっく
cupsoc	セイブカップサッカー	せいぶかっぷさっかー
cv_14	サーカスボルテール (ピンボール)	さーかすぼるてーる
cworld	アドベンチャークイズ カプコンワールド	あどべんちゃーくいずかぷこんわーるど1
cworld2j	アドベンチャークイズ カプコンワールド2	あどべんちゃーくいずかぷこんわーるど2
cyberbal2p	サイバーボール2072	さいばーぼーる2072
cyberlip	サイバーリップ	さいばーりっぷ
cybots	サイバーボッツ - フルメタルマッドネス	さいばーぼっつ
cybrcomm	サイバーコマンド	さいばーこまんど
cybrcycc	サイバーサイクルズ	さいばーさいくるず
cybsled	サイバースレッド	さいばーすれっど
cycln_l5	サイクロン (L-5) (ピンボール)	さいくろんp
cyclwarr	サイクルウォリアーズ	さいくるうぉりあーず
cyvern	サイヴァーン	さいばーん
daiskiss	だい好キッス	だいすきっす
dakkochn	脱子ちゃん雀荘	だっこちゃんはうす
danceyes	ダンシングアイ	だんしんぐあい
dangar	UFOロボ ダンガー	ゆーふぉーろぼだんがー
dangcurv	デンジャラスカーブス	でんじゃらすかーぶす
dangseed	デンジャラスシード	でんじゃらすしーど
darius	ダライアス	だらいあす1
darius2	ダライアスII	だらいあす2
dariusg	ダライアス外伝 - シルバーホーク	だらいあす3
darkedge	ダークエッジ	だーくえっじ
darkmist	ダークミスト	だーくみすと
darkplnt	Dark Planet	だーくぷらねっと
darkseal	ダークシール	だーくしーる1
darkseal2	ダークシールII	だーくしーる2
daytona	デイトナUSA (日本版)	でいとなゆーえすえー1_j
daytona2	デイトナUSA2 - BATTLE ON THE EDGE	でいとなゆーえすえー2
daytonau	デイトナUSA (US版)	でいとなゆーえすえー1_w
dbreedm72	ドラゴンブリード (M72版)	どらごんぶりーど72
dbz	ドラゴンボールZ	どらごんぼーるぜっと1
dbz2	ドラゴンボールZ2 - スーパーバトル	どらごんぼーるぜっと2
dbzvrvs	ドラゴンボールZ V.R.V.S	どらごんぼーるぜっとぶいあーるぶいえす
dd_l2	Dr.デュード (ピンボール)	どくたーでゅーど
ddcrew	D.D.クルー	でぃーでぃーくるー
ddragon	ダブルドラゴン	だぶるどらごん1
ddragon2	ダブルドラゴンII - ザ・リベンジ	だぶるどらごん2
ddragon3	ダブルドラゴン3 - ザ・ロゼッタストーン	だぶるどらごん3
ddribble	ダブルドリブル	だぶるどりぶる
ddsom	ダンジョンズ＆ドラゴンズ - シャドーオーバーミスタラ	だんじょんずあんどどらごんずしゃどーおーばーみすたら
ddtod	ダンジョンズ＆ドラゴンズ - タワーオブドゥーム	だんじょんずあんどどらごんずたわーおぶどぅーむ
ddux	ダイナマイトダックス	だいなまいとだっくす
deadconx	デッドコネクション	でっどこねくしょん
deadweap	デッドリーウェポン (ピンボール)	でっどりーうぇぽん
demonwld	ホラーストーリー	ほらーすとーりー
dendego	電車でGO!	でんしゃでごー1
dendego2	電車でGO!2 - 高速編	でんしゃでごー2
denjinmk	電神魔傀	でんじんまかい
deroon	でろ～んでろでろ	でろーんでろでろ
desertbr	デザートブレーカー	でざーとぶれーかー
desertwr	湾岸戦争 / Desert War	わんがんせんそう
devilfsh	Devil Fish	でびるふぃっしゅ
devilw	魔獣の王国 / Devil World	まじゅうのおうこく
devstors	餓流禍 / Devastators	がるか
dh_lx2	ダーティーハリー (ピンボール)	だーてぃーはりー
dietgo	ダイエットゴーゴー	だいえっとごーごー
digdug	ディグダグ	でぃぐだぐ1
digdug2	ディグダグII	でぃぐだぐ2
diggerma	ディッガーマン (プロトタイプ)	でぃっがーまん
dimahoo	グレート魔法大作戦 / Dimahoo	ぐれーとまほうだいさくせん
diner_l4	ダイナー (L-4) (ピンボール)	だいなー
dino	キャディラックス - 恐竜新世紀	きゃでぃらっくす
dinorex	ダイノレックス	だいのれっくす
dirtdvls	ダートデビルズ	だーとでびるず
dirtfoxj	ダートフォックス	だーとふぉっくす
djboy	DJボーイ (海外版)	でぃーじぇいぼーい_w
djboyj	DJボーイ (日本版)	でぃーじぇいぼーい_j
dkgensan	大工の源さん (日本版)	だいくのげんさん
dleague	ダイナマイトリーグ	だいなまいとりーぐ
dm_h5	デモリッションマン (H-5) (ピンボール)	でもりっしょんまんp
dm_lx4	デモリションマン (ピンボール)	でもりしょんまん
doa	デッド・オア・アライブ	でっどおああらいぶ
docastle	ミスターDo's キャッスル	みすたーどぅーきゃっする
dogosoke	怒号層圏 (日本版)	どごうそうけん
dokaben	ドカベン	どかべん
domino	Domino Man	どみのまん
dondokod	ドンドコドン	どんどこどん
dorunrun	スーパーピエロ / Do! Run Run	すーぱーぴえろ
dotron	ディスクスオブトロン	でぃすくすおぶとろん
doubledr	ダブルドラゴン (Neo Geo)	だぶるどらごんねおじおばん
douni	ミスターDo! VS ユニコーン	みすたーどぅーばーさすゆにこーん
dowild	ミスターDo's ワイルドライド	みすたーどぅーわいるどらいど
drac_l1	ブラムストッカーズ ドラキュラ (L-1) (ピンボール)	ぶらむすとっかーずどらきゅら
dragngun	ドラゴンガン	どらごんがん
dragoona	ドラグーンマイト	どらぐーんまいと
drgnbstr	ドラゴンバスター	どらごんばすたー
driftout	ドリフトアウト	どりふとあうと
drivedge	ドライバーズエッジ	どらいばーずえっじ
driveyes	ドライバーズアイ	どらいばーずあい
dsaber	ドラゴンセイバー	どらごんせいばー
dspirit	ドラゴンスピリット	どらごんすぴりっと
dstlk	ヴァンパイア - ザ・ナイトウォリアーズ	ばんぱいあざないとうぉーりあーず
dumpmtmt	ダンプ松本	だんぷまつもと
dungeonm	ライトブリンガー	らいとぶりんがー
dunkmnia	ダンクマニア	だんくまにあ
dunkshot	ダンクショット	だんくしょっと
dyger	Dyger	だいがー
dynabb	ダイナマイトベースボール	だいなまいとべーすぼーる
dynablst	ボンバーマン / Dynablaster	ぼんばーまん
dynamcop	ダイナマイト刑事2 -カリブの海賊編- / Dynamite Cop	だいなまいとでか2
dynduke	ダイナマイトデューク	だいなまいとでゅーく
dynwar	天地を喰らう / Dynasty Wars (海外版)	てんちをくらう1_w
dynwarj	天地を喰らう (日本版)	てんちをくらう1_j
earthjkr	アースジョーカー	あーすじょーかー
eatpm_l4	エルビラ・アンド・パーティモンスターズ (LA-4) (ピンボール)	えるびらp
eca	救急車 - エマージェンシーコールアンビュランス	きゅうきゅうしゃ
ecofghtr	アルティミットエコロジー / Eco Fighters	あるてぃみっとえころじー
edf	アースディフェンスフォース	あーすでぃふぇんすふぉーす
edrandy	エドワードランディ	えどわーどらんでぃ
ehrgeiz	エアガイツ	えあがいつ
eightman	8マン	えいとまん
elevator	エレベーターアクション	えれべーたーあくしょん
elvactr	エレベーターアクションリターンズ	えれべーたーあくしょんりたーんず
emeralda	エメラルディア	えめらるでぃあ
endurob2	エンデューロレーサー (海賊版 2, YM2203)	えんでゅーろれーさー 3
endurobl	エンデューロレーサー (海賊版 1, YM2203)	えんでゅーろれーさー 2
enduror	エンデューロレーサー	えんでゅーろれーさー 1
enforce	エンフォース	えんふぉーす
eprom	ロボットモンスターズ	ろぼっともんすたーず
equites	エクイテス	えくいてす
esb	スターウォーズ - 帝国の逆襲 / The Empire Strikes Back	すたーうぉーずていこくのぎゃくしゅう
esckids	エスケープキッズ	えすけーぷきっず
esha_la3	アースシェイカー (LA-3) (ピンボール)	あーすしぇいかーp
esprade	エスプレイド	えすぷれいど
eswat	サイバーポリス E-スワット	さいばーぽりすいーすわっと
eto	古今東西干支物語	ここんとうざいえとものがたり
exctleag	エキサイトリーグ	えきさいとりーぐ
exedexes	エグゼドエグゼス	えぐぜどえぐぜす
exterm	Exterminator	えくすたーみねーたー
extrmatn	エクスターミネーション	えくすたーみねーしょｎ
exvania	エクスバニア	えくすばにあ
exzisus	イグジーザス	いぐじーざす
f14_l1	F-14 トムキャット (L-1) (ピンボール)	えふじゅうよんp
f1dream	F-1ドリーム	えふわんどりーむ
f1en	F-1エキゾーストノート	えふわんえきぞーすとのーと
f1gp	F-1グランプリ	えふわんぐらんぷり1
f1gp2	F-1グランプリ Part II	えふわんぐらんぷり2
f1gpstar	グランプリスター	ぐらんぷりすたー
f1lap	F-1スーパーラップ	えふわんすーぱーらっぷ
f1superb	F-1スーパーバトル	えふわんすーぱーばとる
faceoff	フェイスオフ	ふぇいすおふ
fantzone1	ファンタジーゾーン (日本版)	ふぁんたじーぞーん_j
fantzone	ファンタジーゾーン (US版)	ふぁんたじーぞーん_u
fatfursp	餓狼伝説スペシャル / Fatal Fury Special	がろうでんせつ2.5
fatfury1	餓狼伝説 - 宿命の闘い / Fatal Fury	がろうでんせつ1
fatfury2	餓狼伝説2 - 新たなる闘い / Fatal Fury 2	がろうでんせつ2
fatfury3	餓狼伝説3 - 遙かなる闘い / Fatal Fury 3	がろうでんせつ3
fbfrenzy	フットボールフレンジー	ふっとぼーるふれんじー
fcombat	フィールドコンバット	ふぃーるどこんばっと
feversos	弾銃フィーバロン / Fever SOS	だんがんふぃーばろん
ffight	ファイナルファイト	ふぁいなるふぁいと
fghtatck	F/A＜ファイターアンドアタッカー＞	ふぁいたーあんどあたっかー
fghthist	ファイターズヒストリー	ふぁいたーずひすとりー
fgtlayer	ファイティングレイヤー	ふぁいてぃんぐれいやー
fhawk	ファイティングホーク	ふぁいてぃんぐほーく
fieldday	ザ・運動会 / Field Day	ざうんどうかい
fightfev	ファイトフィーバー	ふぁいとふぃーばー
finalap2	ファイナルラップ2	ふぁいなるらっぷ2
finalap3	ファイナルラップ3	ふぁいなるらっぷ3
finalapr	ファイナルラップR	ふぁいなるらっぷ4
finalb	ファイナルブロー	ふぁいなるぶろー
finallap	ファイナルラップ	ふぁいなるらっぷ1
finehour	ファイネストアワー	ふぁいねすとあわー
finfurl2	ファイナルハロン2	ふぁいなるはろん2
fire_l3	ファイア！ (L-3) (ピンボール)	ふぁいあp
firebarr	ファイアーバレル	ふぁいあーばれる
fitegolf	ファイティングゴルフ (海外版?)	ふぁいてぃんぐごるふ
flicky	フリッキー	ふりっきー
flipshot	バトルフリップショット	ばとるふりっぷしょっと
flower	フラワー	ふらわー
flstory	フェアリーランドストーリー	ふぇありーらんどすとーりー
footchmp	ハットトリックヒーロー	はっととりっくひーろー
forgottn	ロストワールド / Forgotten World (海外版)	ろすとわーるど_w
fourtrax	フォートラックス	ふぉーとらっくす
fpoint	フラッシュポイント	ふらっしゅぽいんと
frankst	メリー・シェリーズ・フランケンシュタイン (ピンボール)	めりーしぇりーずふらんけんしゅたいん
freddy	フレディー: ア・ナイトメア・オン・エルム・ストリート (ピンボール)	ふれでぃー
frogger	フロッガー	ふろっがー
ngfrog	Frog Feast	ふろっぐふぃーすと
fromanc2	対戦アイドル麻雀 ファイナルロマンス2	たいせんあいどるまーじゃんふぁいなるろまんす2
fromanc4	対戦麻雀 ファイナルロマンス4	たいせんまーじゃんふぁいなるろまんす4
fromancr	対戦麻雀 ファイナルロマンスR	たいせんまーじゃんふぁいなるろまんすR
frontlin	フロントライン	ふろんとらいん
fround	ハードパンチャー - 血まみれの栄光 / Final Round	はーどぱんちゃー
fs_lx5	フリントストーン (ピンボール)	ふりんとすとーん
fshark	飛翔鮫 / Sky Shark	ひしょうざめ
fstarfrc	ファイナルスターフォース	ふぁいなるすたーふぉーす
ft_l5	フィッシュテイルズ (L-5) (ピンボール)	ふぃっしゅているずp
funkyjet	ファンキージェット	ふぁんきーじぇっと
fvipers	ファイティングバイパーズ	ふぁいてぃんぐばいぱーず
fvipers2	ファイティングバイパーズ2	ふぁいてぃんぐばいぱーず2
g_0tol	Zero Tolerance (メガドライブ)	ぜろとれらんす_m
g_2020	2020年スーパーベースボール (メガドライブ)	にせんにじゅうねんすーぱーべーすぼーる_m
g_2040	Phantom 2040 (メガドライブ)	ふぁんとむ2040_m
g_abea	獣王記 / Altered Beast (メガドライブ)	じゅうおうき_m
g_abus	エアバスター (メガドライブ)	えあばすたー_m
g_abz2	エアーマネジメントII 航空王をめざせ / Aerobiz Supersonic (メガドライブ)	えあーまねじめんと2_m
g_acr2	エアロ・ジ・アクロバット 2 (メガドライブ)	えあろじあくろばっと2_m
g_acro	エアロ・ジ・アクロバット (メガドライブ)	えあろじあくろばっと1_m
g_adiv	エアダイバー (メガドライブ)	えあだいばー_m
g_advdai	アドバンスト大戦略 - ドイツ電撃作戦 (メガドライブ)	あどばんすとだいせんりゃく_m
g_aero	エアーマネジメント 大空に賭ける / Aerobiz (メガドライブ)	えあーまねじめんと1_m
g_alad	アラジン (メガドライブ)	あらじん_m
g_alex	アレックスキッドの天空魔城 / Alex Kidd in the Enchanted Castle (メガドライブ)	あれっくすきっどのてんくうまじょう_m
g_anim	Animaniacs (メガドライブ)	あにまにあっくす_m
g_aof	龍虎の拳 / Art of Fighting (メガドライブ)	りゅうこのけん_m
g_aptg	尾崎直道のスーパーマスターズ / Arnold Palmer Tournament Golf (メガドライブ)	おざきなおみちのすーぱーますたーず_m
g_arca	Arcade Classics (メガドライブ)	あーけーどくらしっくす_m
g_arcu	アークスオデッセイ (メガドライブ)	あーくすおでっせい_m
g_arro	アローフラッシュ (メガドライブ)	あろーふらっしゅ_m
g_aspg	Asterix and the Power of The Gods (メガドライブ)	あすてりくすあんどざぱわーおぶざごっず_m
g_astgru	Asterix and the Great Rescue (メガドライブ)	あすてりくすあんどざぐれーとれすきゅー_m
g_atpt	ATP Tour Championship Tennis (メガドライブ)	えーてひーぴーつあーちゃんぴおんしっぷてにす_m
g_awep	オーサムポッサム (メガドライブ)	おーさむぽっさむ_m
g_babyb2	Baby's Day Out (メガドライブ) (プロトタイプ)	べびーずでいあうと_m
g_balz	3D Ballz (メガドライブ)	すりーでぃーぼーるず_m
g_barb	Barbie Super Model (メガドライブ)	ばーびーすーぱーもでる_m
g_barbvb	Barbie Vacation Adventure (メガドライブ)	ばーびーばけーしょんあどべんちゃー_m
g_basp	Bass Masters Classic - Pro Edition (メガドライブ)	ばすますたーくらしっくぷろ_m
g_bass	Bass Masters Classic (メガドライブ)	ばすますたーくらしっく_m
g_bat	バットマン (メガドライブ)	ばっとまん_m
g_batj	Batman - Revenge of the Joker (メガドライブ)	ばっとまんりべんじおぶざじょーかー_m
g_bbbq	Beauty and the Beast - Belle's Quest (メガドライブ)	びゅーてぃーあんどざびーすとべるずくえすと_m
g_bbrb	Beauty and the Beast - Roar of the Beast (メガドライブ)	びゅーてぃーあんどざびーすとろあおぶざびーすと_m
g_bean	Dr. Robotnik's Mean Bean Machine (メガドライブ)	どくたーろぼてぃんくすみーんびーんましーん_m
g_bear	The Berenstain Bears' Camping Adventure (メガドライブ)	ばれんすたいんべあ_m
g_blee	Dragon - The Bruce Lee Story (メガドライブ)	どらごんざぶるーすりーすとーりー_m
g_blma	Blaster Master 2 (メガドライブ)	ぶらすたーますたー2_m
g_blueal	ブルーアルマナック (メガドライブ)	ぶるーあるまなっく_m
g_bnza	ボナンザブラザーズ (メガドライブ)	ぼなんざぶらざーず_m
g_body	Body Count (メガドライブ)	ぼでぃかうんと_m
g_boxl	Boxing Legends of the Ring (メガドライブ)	ぼくしんぐれじぇんずおぶざりんぐ_m
g_brpw	Brutal - Paws of Fury (メガドライブ)	ぶるーたる_m
g_bsht	Bloodshot (メガドライブ)	ぶらっどしょっと_m
g_btdd	Battletoads and Double Dragon - The Ultimate Team (メガドライブ)	ばとるとーずあんどだぶるどらごん_m
g_btnm	The Simpsons - Bart's Nightmare (メガドライブ)	ざしんぷそんずばーつないとめあ_m
g_btoa	BattleToads (メガドライブ)	ばとるとーず_m
g_buba	Bubba 'n' Stix (メガドライブ)	ぶっばんすてぃっくす_m
g_burf	バーニングフォース (メガドライブ)	ばーにんぐふぉーす_m
g_bzerot	Beyond Zero Tolerance (メガドライブ) (プロトタイプ)	びよんどぜろとれらんす_m
g_c50	キャリバー50 (メガドライブ)	きゃりばーふぃふてぃ_m
g_cada	カダッシュ (メガドライブ)	かだっしゅ_m
g_caes	Caesars Palace (メガドライブ)	しーざーずぱれす_m
g_cano	Cannon Fodder (メガドライブ)	きゃのんふぉっだー_m
g_capp	Captain Planet and the Planeteers (メガドライブ)	きゃぷてんぷらねっと_m
g_casv	バンパイアキラー / Castlevania Bloodlines (メガドライブ)	ばんぱいあきらー_m
g_cc	新創世記ラグナセンティ / Crusader of Centy / Soleil (メガドライブ)	しんそうせいきらぐなせんてぃ_m
g_cfir	CrossFire (メガドライブ)	くろすふぁいあ_m
g_cfn2	College Football's National Championship II (メガドライブ)	かれっじふっとぼーるずなしょなるちゃんぴおんしっぷ_m
g_cgam	California Games (メガドライブ)	かりふぉるにあげーむず_m
g_chav2	Chavez II (メガドライブ)	ちゃべす2_m
g_che2	Chester Cheetah Wild Wild Quest (メガドライブ)	ちぇすたーちーたーわいるどわいるどくえすと_m
g_chik	チキチキボーイズ (メガドライブ)	ちきちきぼーいず_m
g_chouya	超球界ミラクルナイン (メガドライブ)	ちょうきゅうかいみらくるないん_m
g_chq2	スーパーH.Q. / Chase H.Q. II (メガドライブ)	すーぱーえいちきゅー_m
g_cill	Castle of Illusion Starring Mickey Mouse (メガドライブ)	きゃっするおぶいりゅーじょん_m
g_clay	Clay Fighter (メガドライブ)	くれいふぁいたー_m
g_clue	Clue (メガドライブ)	くるー_m
g_col	コラムス (メガドライブ)	こらむす_m
g_col3	コラムスIII - 対決!コラムスワールド (メガドライブ)	こらむす3_m
g_comx	コミックスゾーン (メガドライブ)	こみっくすぞーん_m
g_cont	魂斗羅 ザ・ハードコア (メガドライブ)	こんとらざはーどこあ_m
g_cool	クールスポット (メガドライブ)	くーるすぽっと_m
g_cpoo	Championship Pool (メガドライブ)	ちゃんぴおんしっぷぷーる_m
g_crjb	Cal Ripken Jr. Baseball (メガドライブ)	かるりぷけんじゅにあ_m
g_crkd	クラックダウン (メガドライブ)	くらっくだうん_m
g_crue	クルーボール (メガドライブ)	くるーぼーる_m
g_crys	Crystal's Pony Tale (メガドライブ)	くりすたるずぽにーている_m
g_csla	College Slam (メガドライブ)	かれっじすらむ_m
g_curs	カース (メガドライブ)	かーす_m
g_cutt	Cutthroat Island (メガドライブ)	かっとすろーとあいらんど_m
g_cuty	キューティー鈴木のリングサイドエンジェル (メガドライブ)	きゅーてぃーすずきのりんぐさいどえんじぇる_m
g_cwcs	Champions World Class Soccer (メガドライブ)	ちゃんぴおんずわーるどくらすさっかー_m
g_cybb	CyberBall (メガドライブ)	さいばーぼーる_m
g_cybo	Cyborg Justice (メガドライブ)	さいぼーぐじゃすてぃす_m
g_dahna	ダーナ 女神誕生 (メガドライブ)	だーなめがみたんじょう_m
g_dang	デンジャラスシード (メガドライブ)	でんじゃらすしーど_m
g_dblc	Double Clutch (メガドライブ)	だぶるくらっち_m
g_dc3d	デビルズコース (メガドライブ)	でびるずこーす_m
g_dcat	David Crane's Amazing Tennis (メガドライブ)	でびっどくれーんずあめいじんぐてにす_m
g_ddr3	Double Dragon 3 - The Arcade Game (メガドライブ)	だぶるどらごん3_m
g_dduk	ダイナマイトデューク (メガドライブ)	だいなまいとでゅーく_m
g_ddwe	Dungeons and Dragons - Warriors of the Eternal Sun (メガドライブ)	だんじょんずあんどらごんずうぉーりあーずおぶざえたーなるさん_m
g_desd	Desert Demolition Starring Road Runner and Wile E. Coyote (メガドライブ)	でざーとでもりしょん_m
g_dfry	デビルクラッシュMD / Dragons Fury (メガドライブ)	でびるくらっしゅ_m
g_dialq	脱衣麻雀 ダイヤルQを回せ！ (メガドライブ)	だついまーじゃんだいやるきゅーをまわせ_m
g_dick	ディックトレイシー (メガドライブ)	でぃっくとれいしー_m
g_dicv	Dick Vitale's 'Awesome, Baby!' College Hoops (メガドライブ)	でぃっくびたーれ_m
g_djby	DJボーイ (メガドライブ)	でぃーじぇいぼーい_m
g_dlnd	超闘竜烈伝ディノランド (メガドライブ)	ちょうとうりゅうれつでんでぃのらんど_m
g_dn3d	Duke Nukem 3D (Brazil)	でゅーくにゅーけむ_m
g_dodg	炎の闘球児 ドッジ弾平 (メガドライブ)	ほのおのとうきゅうじどっじだんぺい_m
g_dstr	デザートストライク - 湾岸作戦 (メガドライブ)	でざーとすとらいく_m
g_e_bt	ESPN Baseball Tonight (メガドライブ)	いーえすぴーえぬべーすぼーるとぅないと_m
g_e_hn	ESPN National Hockey Night (メガドライブ)	いーえすぴーえぬほっけーないと_m
g_e_sn	ESPN Sunday Night NFL (メガドライブ)	いーえすぴーえぬないとえぬえふえる_m
g_earn	アーネストエバンス (メガドライブ)	あーねすとえばんず_m
g_ecco	エコー・ザ・ドルフィン (メガドライブ)	えこーざどるふぃん_m
g_ecjr01	Ecco Jr. (メガドライブ) (March 1995)	えこじゅにあ_m
g_eco2	Ecco 2 - The Tides of Time (メガドライブ)	えこ2_m
g_ejim	Earthworm Jim (メガドライブ)	あーすうぉーむじむ1_m
g_elemj	エレメンタルマスター (メガドライブ)	えれめんたるますたー_m
g_elvi	エルヴィエント (メガドライブ)	えるびえんと_m
g_eswa	サイバーポリス E-SWAT / ESWAT - City Under Siege (メガドライブ)	さいばーぽりすいーすわっと_m
g_f1c	F1サーカスMD (メガドライブ)	えふわんさーかすえむでぃー_m
g_f1ce	F1 - World Championship Edition (メガドライブ)	えふわんわーるどちゃんぴおんしっぷえでぃしょん_m
g_fbak	フラッシュバック (メガドライブ)	ふらっしゅばっく_m
g_ferias	Ferias Frustradas do Pica-Pau (メガドライブ)	ふぇりあすふるすとらだす_m
g_feud	Family Feud (メガドライブ)	ふぁみりーふゅーど_m
g_flin	フリントストーン (メガドライブ)	ふりんとすとーん_m
g_fmas	ファイティングマスターズ (メガドライブ)	ふぁいてぃんぐますたーず_m
g_fore	Foreman For Real (メガドライブ)	ふぉーまんふぉーりある_m
g_fpro	サンダープロレスリング列伝 (メガドライブ)	さんだーぷろれすりんぐれつでん_m
g_frgp	フェラーリグランプリチャレンジ (メガドライブ)	ふぇらーりぐらんぷりちゃれんじ_m
g_fshk	鮫！鮫！鮫！ / Fire Shark (メガドライブ)	さめさめさめ_m
g_ftbhb	Frank Thomas Big Hurt Baseball (メガドライブ)	ふらんくとーますびっぐはーとべーすぼーる_m
g_fw	ロストワールド / Forgotten Worlds (メガドライブ)	ろすとわーるど_m
g_fzon	ファイナルゾーン (メガドライブ)	ふぁいなるぞーん_m
g_gain	ゲイングランド (メガドライブ)	げいんぐらんど_m
g_garg	Gargoyles (メガドライブ)	がーごいるず_m
g_gax	ゴールデンアックス (メガドライブ)	ごーるでんあっくす_m
g_gbus	ゴーストバスターズ (メガドライブ)	ごーすとばすたーず_m
g_gcm	マジカルアドベンチャー2 / Great Circus Mystery Starring Mickey & Minnie (メガドライブ)	まじかるあどべんちゃー2_m
g_gemfi	ロイヤルブラッド / Gemfire (メガドライブ)	ろいやるぶらっど_m
g_geng	蒼き狼と白き牝鹿 - 元朝秘史/ Genghis Khan II: Clan of the Grey Wolf (メガドライブ)	あおきおおかみとしろきめじか_m
g_gf2	ギャラクシーフォースII (メガドライブ)	ぎゃらくしーふぉーす2_m
g_gley	グレイランサー / Advanced Busterhawk Gley Lancer (メガドライブ)	ぐらいらんさー_m
g_glos	Generations Lost (メガドライブ)	じぇねれーしょんろすと_m
g_gng	大魔界村 / Ghouls 'N Ghosts (メガドライブ)	だいまかいむら_m
g_gomo	宇宙戦艦ゴモラ (メガドライブ)	うちゅうせんかんごもら_m
g_goof	Goofy's Hysterical History Tour (メガドライブ)	ぐーふぃーずひすてりかるひすとりーつあー_m
g_gran	グラナダ (メガドライブ)	ぐらなだ_m
g_grin	V・V / Grind Stormer (メガドライブ)	ぶいふぁいぶ_m
g_grwl	ルナーク / Growl (メガドライブ)	るなーく_m
g_gtwi	Gadget Twins (メガドライブ)	がじぇっとついんず_m
g_gws	The Great Waldo Search (メガドライブ)	ざぐれーとわるどさーち_m
g_gyno	ジノーグ / Wings of Wor (メガドライブ)	じのーぐ_m
g_hard	ハードドライビン (メガドライブ)	はーどどらいびん_m
g_hell	ヘルファイヤー (メガドライブ)	へるふぁいやー_m
g_herz	ヘルツォーク・ツヴァイ (メガドライブ)	へるつぉーくつばい_m
g_hice	ヒット・ジ・アイス (メガドライブ)	ひっとじあいす_m
g_huni	ヘビーユニット メガドライブスペシャル (メガドライブ)	へびーゆにっとめがどらいぶすぺしゃる_m
g_hybrid	ハイブリッドフロント (メガドライブ)	はいぶりっどふろんと_m
g_icd	The Incredible Crash Dummies (メガドライブ)	ざいんくれでぃぶるくらっしゅだみーず_m
g_insx	インセクターX (メガドライブ)	いんせくたーえっくす_m
g_jamm	Jammit (メガドライブ)	じゃみっと_m
g_jbdb	James "Buster" Douglas Knockout Boxing (メガドライブ)	じぇーむずだぐらすのっくあうとぼくしんぐ_m
g_jbok	The Jungle Book (メガドライブ)	ざじゃんぶるぶっく_m
g_jely	Jelly Boy (メガドライブ) (プロトタイプ)	じぇりーぼーい_m
g_jeop	Jeopardy! (メガドライブ)	じぇおぱーでぃ_m
g_jewl	ジュエルマスター (メガドライブ)	じゅえるますたー_m
g_jim2	Earthworm Jim 2 (メガドライブ)	あーすうぉーむじむ2_m
g_jlp	Jリーグプロストライカー (メガドライブ)	じぇーりーぐぷろすとらいかー1_m
g_jlp2	Jリーグプロストライカー2 (メガドライブ)	じぇーりーぐぷろすとらいかー2_m
g_jlpf	プロストライカー ファイナルステージ (メガドライブ)	ぷろすとらいかーふぁいなるすてーじ_m
g_jltf	Justice League Task Force (メガドライブ)	じゃすてぃすりーぐたすくふぉーす_m
g_jpar	ジュラシックパークMD (メガドライブ)	じゅらしっくぱーく_g_m
g_jpra	Jurassic Park - Rampage Edition (メガドライブ)	じゅらしっくぱーくらんぺーじえでぃしょん_m
g_jstr	ジャングルストライク (メガドライブ)	じゃんぐるすとらいく_m
g_junc	ジャンクション (メガドライブ)	じゃんくしょん_m
g_jwws	Jimmy White's Whirlwind Snooker (Europe)	じみーほわいつわーるうぃんどすぬーかー_m
g_kawa	Kawasaki Superbike Challenge (メガドライブ)	かわさきすーぱーばいくちゃれんじ_m
g_kgk	火激 / Ka-Ge-Ki: Fists of Steel (メガドライブ)	かげき_m
g_kishi	騎士伝説 (メガドライブ)	きしでんせつ_m
g_krew	スケルトンクルー (メガドライブ)	すけるとんくるー_m
g_ksfh	Krusty's Super Fun House (メガドライブ) (v1.1)	くらすてぃーずすーぱーふぁんほーす_m
g_ktm	キング・オブ・モンスターズ (メガドライブ)	きんぐおぶもんすたーず_m
g_ktm2	キング・オブ・モンスターズ2 (メガドライブ)	きんぐおぶもんすたーず2_m
g_land	ランドストーカー - 皇帝の財宝 (メガドライブ)	らんどすとーかー_m
g_lem	レミングス (メガドライブ)	れみんぐす_m
g_librty	Liberty of Death (メガドライブ)	りばてぃーおぶです_m
g_lngr2a	ラングリッサーII (メガドライブ)	らんぐりっさー2_ma
g_lngr2c	ラングリッサーII (メガドライブ)	らんぐりっさー2_mc
g_lordmo	ロードモナーク - とことん戦闘伝説 (メガドライブ)	ろーどもなーく_m
g_lot2	Lotus II: R.E.C.S. (メガドライブ)	ろーたす2_m
g_ma96	Madden NFL 96 (メガドライブ)	までんえぬえふえる_m
g_madou	魔道物語 I (メガドライブ)	まどうものがたり1_m
g_mahb	Muhammad Ali Heavyweight Boxing (メガドライブ)	もはめっどありへびーうぇいとぼくしんぐ_m
g_mano	Man Overboard! (メガドライブ)	まんおーばーぼーど_m
g_mars	Marsupilami (メガドライブ)	まるすぴらみ_m
g_marv	マーベルランド (メガドライブ)	まーべるらんど_m
g_maten	魔天の創滅 (メガドライブ)	まてんのそうめつ_m
g_maui	Donald in Maui Mallard (メガドライブ)	どなるどいんまういまらーど_m
g_mazi	マジンサーガ (メガドライブ)	まじんさーが_m
g_merc	戦場の狼II / Mercs (メガドライブ)	せんじょうのおおかみ2_m
g_mhat	まじかるハットのぶっとびターボ!大冒険 (メガドライブ)	まじかるはっとのぶっとびたーぼ_m
g_mick	Mick and Mack as the Global Gladiators (メガドライブ)	みっくあんどまっくあずざぐろーばるぐらでぃえいたーず_m
g_mk3	Mortal Kombat 3 (メガドライブ)	もーたるこんばっと3_g_m
g_mlfoot	Mutant League Football (メガドライブ)	みゅーたんとりーぐふっとぼーる_m
g_mmf	Marko's Magic Football (メガドライブ)	まるこずまじっくふっとぼーる_m
g_mmpr	Mighty Morphin Power Rangers (メガドライブ)	まいてぃもーふぃんぱわーれんじゃーず_m
g_mono	モノポリー (メガドライブ)	ものぽりー_m
g_mowe	マスターオブウエポン (メガドライブ)	ますたーおぶうえぽん_m
g_msbu	The Magic School Bus (メガドライブ)	ざまじっくすくーるばす_m
g_mult	Mickey's Ultimate Challenge (メガドライブ)	みっきーずあるてぃみっとちゃれんじ_m
g_mush	武者アレスタ / M.U.S.H.A (メガドライブ)	むしゃあれすた_m
g_must	ファイアームスタング (メガドライブ)	ふぁいあーむすたんぐ_m
g_mysf	Mystical Fighter (メガドライブ)	みすてぃかるふぁいたー_m
g_na95	NBA Action '95 Starring David Robinson (メガドライブ)	えぬびーえーあくしょん95_m
g_nash	NHL All-Star Hockey '95 (メガドライブ)	えぬえいちえるおーるすたーほっけー95_m
g_ncff	NCAA Final Four Basketball (メガドライブ)	えぬしーえーえーふぁいなるばすけっとぼーる_m
g_new3dg	遙かなるオーガスタ (メガドライブ)	はるかなるおーがすた_m
g_nfl5	NFL '95 (メガドライブ)	えぬえふえる95_m
g_nfpt	Prime Time NFL Starring Deion Sanders (メガドライブ)	ぷらいむたいむえぬえふえるすたーりんぐでいおんさんだーす_m
g_nigel	Nigel Mansell's World Championship Racing (メガドライブ)	ないじぇるまんせるずわーるどちゃんぴおんしっぷれーしんぐ_m
g_nikkan	日刊スポーツプロ野球VAN (メガドライブ)	にっかんすぽーつぷろやきゅう_m
g_njam	NBA Jam (メガドライブ) (v1.1)	えぬびーえーじゃむ_g_m
g_njte	NBA Jam Tournament Edition (メガドライブ)	えぬびーえーじゃむとーなめんとえでぃしょｎ_g_m
g_nl97	NBA Live '97 (メガドライブ)	えぬびーえーらいぶ97_m
g_nl98	NBA Live '98 (メガドライブ)	えぬびーえーらいぶ98_m
g_nobbus	信長の野望 武将風雲録 (メガドライブ)	のぶながのやぼうぶしょうふううんろく_m
g_noblor	信長の野望 覇王伝 (メガドライブ)	のぶながのやぼうはおうでん_m
g_nobu	信長の野望 全国版 (メガドライブ)	のぶながのやぼうぜんこくばん_m
g_norm	Normy's Beach Babe-O-Rama (メガドライブ)	のーみーずびーちべいぶおらま_m
g_nqc	NFL Quarterback Club (メガドライブ)	えぬえふえるくおーたーばっくくらぶ_m
g_nqc6	NFL Quarterback Club 96 (メガドライブ)	えぬえふえるくおーたーばっくくらぶ96_m
g_ootw	アウターワールド / Out of This World (メガドライブ)	あうたーわーるど_m
g_ooze	ジ・ウース (メガドライブ)	じうーず_m
g_opeu	ヨーロッパ戦線 / Operation Europe - Path to Victory 1939-45 (メガドライブ)	よーろっぱせんせん_m
g_or20	アウトラン2019 (メガドライブ)	あうとらん2019_m
g_orun	アウトラン (メガドライブ)	あうとらん_m
g_orur	アウトランナーズ (メガドライブ)	あうとらんなーず_m
g_osom	おそ松くん はちゃめちゃ劇場 (メガドライブ)	おそまつくん_m
g_page	The Pagemaster (メガドライブ)	ざぺーじますたー_m
g_patb	Pat Riley Basketball (メガドライブ)	ぱっとらいりーばすけっとぼーる
g_patlab	機動警察パトレイバー - 98式起動せよ! (メガドライブ)	きどうけいさつぱとれいばー_m
g_pbgl	ペブルビーチの波濤 (メガドライブ)	ぺぶるびーちのはとう_m
g_pidw	The Pirates of Dark Water (メガドライブ) (January 1994)	ざぱいれーつおぶだーくうぉーたー_m
g_pifg	ピットファイター (メガドライブ)	ぴっとふぁいたー_m
g_pmon	パワーモンガー (メガドライブ)	ぱわーもんがー_m
g_prin	プリンス・オブ・ペルシャ (メガドライブ)	ぷりんすおぶぺるしゃ_m
g_prqu	Pro Quarterback (メガドライブ)	ぷろくおーたーばっく_m
g_pst	Pete Sampras Tennis (メガドライブ)	ぴーとさんぷらすてにす_m
g_pst3	時の継承者 ファンタシースターIII (メガドライブ)	ときのけいしょうしゃふぁんたしーすたー3
g_pto	提督の決断 / Pacific Theater of Operations (メガドライブ)	ていとくのけつだん_m
g_puyo	ぷよぷよ (メガドライブ)	ぷよぷよ_m
g_r3k2	三國志II / Romance of the Three Kingdoms II (メガドライブ)	さんごくし2_m
g_r3k3	三國志III / Romance of the Three Kingdoms III (メガドライブ)	さんごくし3_m
g_race	Race Drivin' (メガドライブ)	れーすどらいびん_m
g_raid	雷電伝説 / Raiden Trad (メガドライブ)	らいでんでんせつ_m
g_rain	レインボーアイランドエキストラ (メガドライブ)	れいんぼーあいらんどえきすとら_m
g_ram3	ランボー3 (メガドライブ)	らんぼー3_m
g_ranx	エクスランザー / Ranger-X (メガドライブ)	えくすらんざー_m
g_rast	ラスタンサーガ2 (メガドライブ)	らすたんさーが2_m
g_rb3	R.B.I. Baseball 3 (メガドライブ)	あーるびーあいべーすぼーる3_m
g_rb4	R.B.I. Baseball 4 (メガドライブ)	あーるびーあいべーすぼーる4_m
g_rb93	R.B.I. Baseball '93 (メガドライブ)	あーるびーあいべーすぼーる93_m
g_rb94	R.B.I. Baseball 94 (メガドライブ)	あーるびーあいべーすぼーる94_m
g_rbls	ロードブラスターズ (メガドライブ)	ろーどぶらすたーず_m
g_rens	The Ren and Stimpy Show Presents Stimpy's Invention (メガドライブ)	ざれんあんどすてぃんぴーしょーぷれぜんつすてぃんぴーずいんべんしょん_m
g_rkni	ロケットナイトアドベンチャーズ (メガドライブ)	ろけっとないとあどべんちゃーず_m
g_robt	RoboCop Versus The Terminator (メガドライブ)	ろぼこっぷばーさすざたーみねーたー_m
g_robw	The Adventures of Rocky and Bullwinkle and Friends (メガドライブ)	あどべんちゃーおぶろっきーあんどぶるうぃんくる_m
g_rrr	ロックンロールレーシング (メガドライブ)	ろっくんろーるれーしんぐ_m
g_s_ar	Spider-Man and X-Men in Arcade's Revenge (メガドライブ)	すぱいだーまんあんどえっくすめん_m
g_s_as	スパイダーマン (メガドライブ) (Acclaim)	すぱいだーまん_m
g_s_mc	Spider-Man & Venom - Maximum Carnage (メガドライブ)	すぱいだーまんあんどべのむまきしまむかーねーじ_m
g_s_sa	Spider-Man & Venom - Separation Anxiety (メガドライブ)	すぱいだーまんあんどべのむせぱれーしょんあんぐざいあてぃ_m
g_s3d	ソニック3Dブラスト (メガドライブ)	そにっくすりーでぃーぶらすと_m
g_sagia	ダライアスII / Sagaia (メガドライブ)	だらいあす2_m
g_sair	スーパーエアーウルフ / CrossFire (メガドライブ)	すーぱーえあーうるふ_m
g_sangor	三国志列伝 - 乱世の英雄たち (メガドライブ)	さんごくしれつでん_m
g_sbe2	Shadow of the Beast 2 (メガドライブ)	しゃどうおぶざびーすと2_m
g_sbls	四天明王 / Shadow Blasters (メガドライブ)	してんみょうおう_m
g_sbt	スーパーバトルタンク (メガドライブ)	すーぱーばとるたんく_m
g_scob	Scooby Doo Mystery (メガドライブ)	すくーびーどぅーみすてりー_m
g_sdnk	スラムダンク 強豪真っ向対決 (メガドライブ)	すらむだんく_m
g_seaq	SeaQuest DSV (メガドライブ)	しーくえすとでぃーえすぶい_m
g_semp	鋼鉄帝国 / The Steel Empire (メガドライブ)	こうてつていこく_m
g_sfz	スーパーファンタジーゾーン (メガドライブ)	すーぱーふぁんたじーぞーん_m
g_shaq	Shaq Fu (メガドライブ)	しゃくふ_m
g_shar	スペースハリアーII (メガドライブ)	すぺーすはりあー2_m
g_shdrkj	シャイニング・アンド・ザ・ダークネス (メガドライブ)	しゃいにんぐあんどざだーくねす_m
g_shf1	シャイニングフォース (メガドライブ)	しゃいにんぐふぉーす1_m
g_shf2	シャイニング・フォースII 古えの封印 (メガドライブ)	しゃいにんぐふぉーす2_m
g_shi	スーパーハイインパクト (メガドライブ)	すーぱーはいいんぱくと_g_m
g_shikin	紫禁城 (メガドライブ)	しきんじょう_m
g_sho	スーパーハングオン (メガドライブ)	すーぱーはんぐおん_m
g_shogi	将棋の星 (メガドライブ)	しょうぎのほし_m
g_shura	修羅の門 (メガドライブ)	しゅらのもん_m
g_si91	スペースインベーダー90 (メガドライブ)	すぺーすいんべーだー90_m
g_sks3	ソニック・アンド・ナックルズ (メガドライブ)	そにっくあんどなっくるずあんどそにっく3_m
g_sl91	プロ野球スーパーリーグ '91 (メガドライブ)	ぷろやきゅうすーぱーりーぐ91_m
g_smf	The Smurfs (メガドライブ)	ざすまーふす_m
g_smgp03	スーパーモナコGP (メガドライブ)	すーぱーもなこぐらんぷり_m
g_snow	スノーブラザーズ (メガドライブ)	すのーぶらざーず_m
g_soff	Super Off Road (メガドライブ)	すーぱーおふろーど_m
g_sold	ソルフィース / Sol-Deace (メガドライブ)	そるふぃーす_m
g_son2	ソニック・ザ・ヘッジホッグ2 (メガドライブ)	そにっくざへっじほっぐ2_m
g_son3	ソニック・ザ・ヘッジホッグ3 (メガドライブ)	そにっくざへっじほっぐ3_m
g_sons	ソニック・スピンボール (メガドライブ)	そにっくすぴんぼーる_m
g_spir	Spirou (メガドライブ)	すぱいろう_m
g_spo2	スポット ゴーズトゥーハリウッド (メガドライブ)	すぽっとごーずとぅはりうっど_m
g_sprk	スパークスター - ロケットナイトアドベンチャー2 (メガドライブ)	すぱーくすたー_m
g_srr	Snake Rattle n Roll (メガドライブ)	すねーくらっとるんろーる_m
g_srun	Shadowrun (メガドライブ)	しゃどうらん_m
g_ssma	ストリートスマート (メガドライブ)	すとりーとすまーと_m
g_ssri	サンセットライザーズ (メガドライブ)	さんせっとらいだーず_m
g_sswo	セイントソード (メガドライブ)	せいんとそーど_m
g_stalon	スティールタロンズ (メガドライブ)	すてぃーるたろんず_m
g_stb	スーパーサンダーブレード (メガドライブ)	すーぱーさんだーぶれーど_m
g_std9	Star Trek Deep Space 9 - Crossroads of Time (メガドライブ)	すたーとれっくでぃーぷすぺーすないん
g_supm	Superman (メガドライブ)	すーぱーまん_m
g_sydval	SDヴァリス / Syd of Valis (メガドライブ)	えすでぃーばりす_m
g_taiga	太平記 (メガドライブ)	たいへいき_m
g_taikou	太閤立志伝 (メガドライブ)	たいこうりっしでん_m
g_tanr	タントアール (メガドライブ)	たんとあーる_m
g_tc	Tecmo Cup (メガドライブ)	てくもかっぷ_m
g_tcls	テクノクラッシュ (メガドライブ)	てくのくらっしゅ_m
g_td2	Test Drive II - The Duel (メガドライブ)	てすとどらいぶ2
g_telmj	TEL・TELまあじゃん (メガドライブ)	てるてるまーじゃん_m
g_telstd	TEL・TELスタジアム (メガドライブ)	てるてるすたじあむ_m
g_tetr	テトリス (メガドライブ)	てとりす_m
g_tf2	サンダーフォースII (メガドライブ)	さんだーふぉーす2_m
g_tf3	サンダーフォースIII (メガドライブ)	さんだーふぉーす3_m
g_tf4	サンダーフォースIV (メガドライブ)	さんだーふぉーす4_m
g_tfox	サンダーフォックス (メガドライブ)	さんだーふぉっくす_m
g_tg2	Top Gear 2 (メガドライブ)	とっぷぎあ2_m
g_tick	The Tick (メガドライブ)	ざてぃっく_m
g_tinh	Tinhead (メガドライブ)	てぃんへっど_m
g_tint	Tintin au Tibet (メガドライブ)	てぃんてぃんおてぃべっと_m
g_tje2	Toe Jam and Earl in Panic on Funkotron (メガドライブ)	とぅーじゃむあんどあーるいんぱにっくおんふぁんくおとろん_m
g_tnnb	TNN Bass Tournament of Champions (メガドライブ)	てぃーえぬえぬばすとーなめんとおぶちゃんぴおんず_m
g_tnno	TNN Outdoors Bass Tournament '96 (メガドライブ)	てぃーえぬえぬあうとどあばすとーなめんと96_m
g_tnzs	ザ・ニュージーランドストーリー (メガドライブ)	ざにゅーじーらんどすとーりー_m
g_toug	Toughman Contest (メガドライブ)	とーとまんこんてすと
g_toxi	Toxic Crusaders (メガドライブ)	ときしっくくるせーだーず_m
g_toy	Toy Story (メガドライブ)	といすとーりー_m
g_toys	Toys (メガドライブ)	といず_m
g_trux	達人 / Truxton (メガドライブ)	たつじん_m
g_tsh	スーパーホッケー (メガドライブ)	てくもすーぱーほっけー_m
g_tsnb	テクモスーパーNBAバスケットボール (メガドライブ)	てくもすーぱーえぬびーえー_m
g_tta	Tiny Toon Adventures - Buster's Hidden Treasure (メガドライブ)	たいにーとぅーんあどべんちゃーずばすたーずひどぅんとれじゃー
g_ttaa	タイニー・トゥーン・アドベンチャーズ (メガドライブ)	たいにーとぅーんあどべんちゃーず
g_ttnk	Thomas The Tank Engine and Friends (メガドライブ)	とーますざたんくえんじんあんどふれんず_m
g_turt	Teenage Mutant Ninja Turtles - The Hyperstone Heist (メガドライブ)	てぃーんえいじみゅーたんとにんじゃたーとるずざはいぱーすとーんはいすと
g_tw93	テクモワールドカップ '93 (メガドライブ)	てくもわーるどかっぷ93_m
g_twih	大旋風 / Twin Hawk (メガドライブ)	だいせんぷう_m
g_uded	アンデッドライン (メガドライブ)	あんでっどらいん_m
g_umk3	Ultimate Mortal Kombat 3 (メガドライブ)	あるてぃめっともーたるこんばっと3_m
g_uqix	ヴォルフィード / Ultimate Qix (メガドライブ)	ぼるふぃーど_m
g_uw	大航海時代 / Uncharted Waters (メガドライブ)	だいこうかいじだい1_m
g_uwnh	大航海時代 II / Uncharted Waters - New Horizons (メガドライブ)	だいこうかいじだい2_m
g_uzuke	Uzu Keobukseon (メガドライブ)	うずけおぶくせおん_m
g_vbar	バーチャルバート (メガドライブ)	ばーちゃるばーと_m
g_vf2	バーチャファイター2 (メガドライブ)	ばーちゃふぁいたー2_m
g_view	ビューポイント (メガドライブ)	びゅーぽいんと_m
g_waiala	ワイアラエの奇蹟 (メガドライブ)	わいあらえのきせき_m
g_wani	ワニワニワールド (メガドライブ)	わにわにわーるど_m
g_ward	ワードナの森スペシャル (メガドライブ)	わーどなのもり_m
g_wars	ラングリッサー / Warsong (メガドライブ)	らんぐりっさー_m
g_weap	WeaponLord (メガドライブ)	うえぽんろーど
g_wfsw	WWF Super WrestleMania (メガドライブ)	だぶりゅーだぶりゅーえふすーぱーれっするまにあ_m
g_wher	ワールドヒーローズ (メガドライブ)	わーるどひーろーず_m
g_whip	ウイップラッシュ 惑星ボルテガスの謎 / Whip Rush 2222 AD (メガドライブ)	うぃっぷらっしゅ_m
g_wild	Wild Snake (メガドライブ) (プロトタイプ)	わいるどすねーく_m
g_will	World of Illusion Starring Mickey Mouse and Donald Duck (メガドライブ)	わーるどおぶいりゅーじょんすたーりんぐみっきーまうすあんどどなるどだっく_m
g_wimb	ウィンブルドン / Wimbledon Championship Tennis (メガドライブ)	うぃんぶるどん_m
g_wrom	シーザーの野望 / Warrior of Rome (メガドライブ)	しーざーのやぼう_m
g_xdaze	XDR - X-Dazedly-Ray (メガドライブ)	えっくすでぃーあーる_m
g_xmen	X-Men (メガドライブ)	えっくすめん_g_m
g_ys3	イースIII - ワンダラーズ・フロム・イース (メガドライブ)	いーす3_m
g_zanya	斬 - 夜叉円舞曲 / Zan Yasha Enbuden (メガドライブ)	ざんやしゃえんぶきょく_m
g_zoom	ズーム！ (メガドライブ)	ずーむ_m
g_zoop	ズープ (メガドライブ)	ずーぷ_m
g_ztks	Zero The Kamikaze Squirrel (メガドライブ)	ぜろざかみかぜすくうぃれる_m
g_zwin	ゼロウィング (メガドライブ)	ぜろうぃんぐ_m
g13knd	ゴルゴ13 奇跡の弾道	ごるごさーてぃーんきせきのだんどう
ga2	ゴールデンアックス - デスアダーの復讐	ごーるでんあっくす
gaiapols	ガイアポリス - 黄金鷹の剣	がいあぽりす
galaga	ギャラガ	ぎゃらが
galaga88	ギャラガ'88	ぎゃらが88
galastrm	ギャラクティックストーム	ぎゃらくてぃっくすとーむ
galaxyfg	ギャラクシーファイト - ユニバーサル・ウォリアーズ	ぎゃらくしーふぁいと
galivan	コスモポリス ギャリバン	こすもぽりすぎゃりばん
gallop	ギャロップ - Armed Police Unit	ぎゃろっぷ
galmedes	ガルメデス	がるめです
gametngk	ゲーム天国 - ザ・ゲームパラダイス！	げーむてんごく
ganryu	武蔵巌流記	むさしがんりゅうき
gaplus	ギャプラス	ぎゃぷらす
gardia	ガルディア	がるでぃあ
garogun	Garogun Seroyang (韓国版)	がろぐんせろやん
garou	餓GAROU狼 - Mark of the Wolves	がろうまーくおぶざうるぶす
garyoret	臥竜列伝	がりょうれつでん
gaunt2	ガントレットII	がんとれっと2
gauntlet	ガントレット	がんとれっと1
gbusters	クレイジーコップ / Gang Busters	くれいじーこっぷ
gekiridn	逆鱗弾	げきりんだん
gekisou	激走	げきそう
gemini	ジェミニウィング	じぇみにういんぐ
genpeitd	源平討魔伝	げんぺいとうまでん
getstar	ゲットスター	げっとすたー
gforce2	ギャラクシーフォースII	ぎゃらくしーふぉーす2
ghlpanic	オーバキューン / Ghoul Panic	おーばきゅーん
ghostb	迷宮ハンターG / Real Ghost Busters (US版)	めいきゅうはんたーじー
ghostlop	ゴーストロップ	ごーすとろっぷ
ghouls	大魔界村	だいまかいむら
gigawing	ギガウィング	ぎがうぃんぐ
gijoe	G.I.ジョー	じーあいじょー
ginganin	銀河任侠伝	ぎんがにんきょうでん
ginkun	がんばれギンくん	がんばれぎんくん
gladiatp	グラディエイター (ピンボール)	ぐらでぃえーたー
gladiatr	黄金の城 / Gradiator	おうごんのしろ
gldneye	007 ゴールデンアイ (ピンボール)	ぜろぜろせぶんごーるでんあい
gloc	G-LOC	じーろっく
gng	魔界村 / Ghosts'n Goblins	まかいむら
gnr_300	ガンズ・アンド・ローゼズ (ピンボール)	がんずあんどろーぜず
goalx3	ゴール！ゴール！ゴール！	ごーるごーるごーる
godzilla	ゴジラ	ごじら
godzillp	ゴジラ (ピンボール)	ごじらp
fantjour	極上パロディウス - 過去の栄光を求めて	ごくじょうぱろでぃうす
goldcue	ゴールデンキュー (ピンボール)	ごーるでんきゅー
goldnaxe	ゴールデンアックス	ごーるでんあっくす
golgo13	ゴルゴ13	ごるごさーてぃーん
gollygho	ゴーリーゴースト	ごーりーごーすと
gondo	魔境戦士 / Gondomania	まきょうせんし
goodejan	グッとE雀 - 勝ち抜き麻雀賞金王!!	ぐっといーじゃん
gowcaizr	超人学園ゴウカイザー	ちょうじんがくえんごうかいざー
gpilots	ゴーストパイロット	ごーすとぱいろっと
gprider	GPライダー	じーぴーらいだー
gradius	グラディウス	ぐらでぃうす
gradius3	グラディウスIII - 伝説から神話へ	ぐらでぃうす3
gradius4	グラディウスIV - 復活	ぐらでぃうす4
grand_l4	グランドリザード (L-4) (ピンボール)	ぐらんどりざーどp
gratia	セカンドアース グラティア	せかんどあーすぐらてぃあ
grobda	グロブダー	ぐろぶだー
groundfx	グランドエフェクト / スーパーグランドエフェクト	ぐらんどえふぇくと
growl	ルナーク	るなーく
gs_l4	ザ・バリー・ゲームショー (L-4) (ピンボール)	ざばりーげーむしょーp
gseeker	グリッドシーカー	ぐりっどしーかー
gslgr94j	グレートスラッガーズ'94 (日本版)	ぐれーとすらっがーず94
gslgr94u	グレートスラッガーズ'94	ぐれーとすらっがーず94
gslugrsj	グレートスラッガーズ	ぐれーとすらっがーず
gstriker	グランドストライカー	ぐらんどすとらいかー
gt3d	Golden Tee 3D Golf (also '97-Classic)	ごーるでんてぃーすりーでぃーごるふ
gt3dv18	Golden Tee 3D Golf (v1.8)	ごーるでんてぃーすりーでぃーごるふ1.8
gticlub	GTIクラブ	じーてぃーあいくらぶ
guardian	ガーディアンオブザフッド	がーでぃあんおぶざふっど
gulfwar2	Gulf War II	がるふうぉー2
gunbird	ガンバード	がんばーど
gunblade	ガンブレードNY	がんぶれーどにゅーよーく
gunbustr	ガンバスター	がんばすたー
gunforc2	ジオストーム / Gunforce 2	じおすとーむ
gunforce	ガンフォース	がんふぉーす
gunfront	ガンフロンティア	がんふろんてぃあ
gunlock	レイフォース / GunLock	れいふぉーす
gunsmoke	ガンスモーク	がんすもーく
gururin	ぐるりん	ぐるりん
guts	Guts n' Glory (プロトタイプ)	がっつんぐろーりー
guwange	ぐわんげ	ぐわんげ
gw_l5	ザ・ゲートウェイ - ハイスピードII (L-5) (ピンボール)	ざげーとうぇいp
gwar	ゲバラ	げばら
gwarrior	ギャラクティックウォーリアーズ	ぎゃらくてぃっくうぉーりあーず
gyruss	ジャイラス	じゃいらす
hachoo	破兆！	はちょう
halleys	ハレーズコメット	はれーずこめっと
hangon	ハングオン	はんぐおん
harddunk	ハードダンク 3on3	はーどだんく
hardyard	Hard Yardage	はーどやーでじ
harley	ハーレーダビッドソン＆L.A.ライダーズ	はーれーだびっっどそんあんどえるえーらいだーず
hasamu	覇沙夢	はさむ
hatena	アドベンチャークイズ2 ハテナ？の大冒険	あどべんちゃーくいず2はてなのだいぼうけん
hayaosi1	早押しクイズ 王座決定戦	はやおしくいず1
hayaosi2	早押しクイズ グランドチャンピオン大会	はやおしくいず2
hayaosi3	早押しクイズ 熱闘生放送！	はやおしくいず3
hbarrel	ヘビーバレル	へびーばれる
hcastle	悪魔城ドラキュラ	あくまじょうどらきゅら
heatbrl	ヒーテッドバレル	ひーてっどばれる
heavyunt	ヘビーユニット	へびーゆにっと
hellfire	ヘルファイヤー	へるふぁいやー
hharry	大工の源さん / Hammerin' Harry (海外版)	だいくのげんさん_w
hiimpact	High Impact Football	はいいんぱくとふっとぼーる
hippodrm	ファイティングファンタジー / Hippodrome	ふぁいてぃんぐふぁんたじー
hitice	ヒットジアイス	ひっとじあいす
holo	ホロシアム	ほろしあむ
hook	フック	ふっく
hook_408	フック (ピンボール)	ふっく_ぴ
hoops	フープス (ピンボール)	ふーぷす_p
hopmappy	ホッピングマッピー	ほっぴんぐまっぴー
horekid	キッドのホレホレ大作戦	きっどのほれほれだいさくせん
horizon	Horizon	ほらいずん
hotchase	ホットチェイス	ほっとちぇいす
hotd	ザ・ハウス・オブ・ザ・デッド	ざはうすおぶざでっど
hotdogst	Hotdog Storm	ほっとどっぐすとーむ
hs_l4	ハイスピード (L-4) (ピンボール)	はいすぴーどp
hsf2	ハイパーストリートファイター2 - アニバーサリーエディション	はいぱーすとりーとふぁいたー2
hunchbks	Hunchback (スクランブル基板)	はんちばっく
hustler	ビデオハスラー	びでおはすらー
hvoltage	ハイボルテージ	はいぼるてーじ
hvymetal	ヘビーメタル	へびーめたる
hwchamp	ヘビーウェイトチャンプ	へびーうぇいとちゃんぷ
hwrace	ハイウェイレース	はいうぇいれーす
hydra	Hydra	はいどら
hyprduel	ハイパーデュエル	はいぱーでゅえる
i500_11r	インディアナポリス500 (ピンボール)	いんでぃあなぽりす500
id4	インデペンデンス・デイ - ID4 (ピンボール)	いんでぺんでんすでい
iganinju	伊賀忍術伝 - 五神の書	いがにんじゅつでん
ij_l7	インディージョーンズ (ピンボール)	いんでぃーじょーんず
ikari	怒	いかり1
ikari3	怒III	いかり3
imgfight	イメージファイト	いめーじふぁいと
imsorry	ごんべえのあいむそ～り～	ごんべえのあいむそーりー
indy500	インディ500	いんでぃふぁいぶはんどれっど
indytemp	インディージョーンズ	いんでぃーじょーんず
inthunt	海底大戦争 / In The Hunt	かいていだいせんそう
ironhors	大列車強盗 / Iron Horse	だいれっしゃごうとう
irrmaze	ウルトラ電流イライラ棒 / The Irritating Maze	うるとらでんりゅういらいらぼう
jackal	特殊部隊ジャッカル	とくしゅぶたいじゃっかる
janshin	雀神伝説 - QUEST OF JONGMASTER	じゃんしんでんせつ
jb_10r	ジャックボット (ピンボール)	じゃっくぽっと
jd_l7	ジャッジドレッド (ピンボール)	じゃっじどれっど
jdreddp	Judge Dredd	じゃっじどれっど
jedi	スターウォーズ - ジェダイの復讐	すたーうぉーずじぇだいのふくしゅう

jjack	ジャンピングジャック	じゃんぴんぐじゃっく
jm_12r	ジョニーニーモニック (ピンボール)	じょーにーにーもにっく
jockeygp	Jockey Grand Prix	じょっきーぐらんぷり
journey	Journey	じゃーにー
joust2	Joust 2 - Survival of the Fittest	じゃうすと2
joyjoy	ジョイジョイキッド	じょいじょいきっど
jpark	ジュラシックパーク	じゅらしっくぱーく
jplstw22	ザ・ロストワールド - ジュラシックパーク (ピンボール)	ざろすとわーるど
jrpacman	ジュニアパックマン	じゅにあぱっくまん
jungler	ジャングラー	じゃんぐらー
jupk_513	ジュラシックパーク (ピンボール)	じゅらしっくぱーく
jy_12	ジャンクヤード (ピンボール)	じゃんくやーど
jyangoku	雀國志 - 覇王の采牌	じゃんごくし
kabukikl	天外魔境真伝 / Far East of Eden - Kabuki Klash	てんがいまきょうしんでん
kabukiz	歌舞伎Z	かぶきぜっと
kaiserkn	カイザーナックル	かいざーなっくる
kaiunqz	開運クイズ・幸福の旅人	かいうんくいず
karianx	Karian Cross	かりあんくろす
karnov	カルノフ	かるのふ
karnovr	ファイターズヒストリーダイナマイト / Karnov's Revenge	ふぁいたーずひすとりーだいなまいと
kengo	剣豪	けんごう
kick	キックマン	きっくまん
kickoff	キックオフ	きっくおふ
kickridr	キックライダー	きっくらいだー
kidniki	快傑ヤンチャ丸 / Kid Niki	かいけつやんちゃまる
kikcubic	迷宮島 / Kickle Cubele	めいきゅうじま
kikikai	奇々怪界	ききかいかい
kikstart	キックスタート	きっくすたーと
kinst	Killer Instinct	きらーいんすてぃんくと1
kinst2	Killer Instinct 2	きらーいんすてぃんくと2
kirarast	流星雀士キララ☆スター	りゅうせいじゃんしきららすたー
kittenk	にゃんにゃんパニック / Kitten Kaboodle	にゃんにゃんぱにっく
kizuna	風雲スーパータッグバトル / Kizuna Encounter	ふううんすーぱーたっぐばとる
klaxp1	クラックス (プロトタイプ1)	くらっくす
knckhead	ナックルヘッズ	なっくるへっず
kncljoe	ナックルジョー	なっくるじょー
knights	ナイツ・オブ・ザ・ラウンド	ないつおぶざらうんど
kod	ザ・キング・オブ・ドラゴンズ (海外版)	ざきんぐおぶどらごんず_w
kodj	ザ・キング・オブ・ドラゴンズ (日本版)	ざきんぐおぶどらごんず_j
kozure	子連れ狼	こづれおおかみ
kof2000	ザ・キング・オブ・ファイターズ 2000	ざきんぐおぶふぁいたーず2000
kof2001	ザ・キング・オブ・ファイターズ 2001	ざきんぐおぶふぁいたーず2001
kof2002	ザ・キング・オブ・ファイターズ 2002	ざきんぐおぶふぁいたーず2002 
kof2003	ザ・キング・オブ・ファイターズ 2003	ざきんぐおぶふぁいたーず2003
kof94	ザ・キング・オブ・ファイターズ '94	ざきんぐおぶふぁいたーず1994
kof95	ザ・キング・オブ・ファイターズ '95	ざきんぐおぶふぁいたーず1995
kof96	ザ・キング・オブ・ファイターズ '96	ざきんぐおぶふぁいたーず1996
kof97	ザ・キング・オブ・ファイターズ '97	ざきんぐおぶふぁいたーず1997
kof98	ザ・キング・オブ・ファイターズ '98	ざきんぐおぶふぁいたーず1998
kof99	ザ・キング・オブ・ファイターズ '99	ざきんぐおぶふぁいたーず1999
konamigt	レッドファイター2	れっどふぁいたー2
koshien	嗚呼栄光の甲子園	ああえいこうのこうしえん
kotm	キング・オブ・ザ・モンスターズ	きんぐおぶざもんすたーず
kotm2	キング・オブ・ザ・モンスターズ2	きんぐおぶざもんすたーず2
kouyakyu	ザ・高校野球	ざこうこうやきゅう
kroozr	Kozmik Kroozr	こずみっくくるーざー
kungfum	スパルタンX / Kung Fu Master	すぱるたんえっくす
kuniokun	熱血硬派くにお君	ねっけつこうはくにおくん
kurikint	功里金団	くりきんとん
kyukaidk	球界道中記	きゅうかいどうちゅうき
lah_112	ラストアクションヒーロー (ピンボール)	らすとあくしょんひーろー
landgear	ランディングギア	らんでぃんぐぎあ
landmakr	ランドメーカー	らんどめーかー
lastblad	幕末浪漫 月華の剣士 / The Last Blade	ばくまつろまん1
lastbld2	幕末浪漫第二幕 月華の剣士 - 月に咲く華、散りゆく花 / The Last Blade 2	ばくまつろまん2
lastbrnx	ラストブロンクス - 東京番外地	らすとぶろんくす
lastduel	ラストデュエル	らすとでゅえる
lastmisn	ラストミッション	らすとみっしょん
lbgrande	リベログランデ	りべろぐらんで
lbowling	リーグボウリング	りーぐぼうりんぐ
lca	ライツ・カメラ・アクション (ピンボール)	らいつかめらあくしょん
ldrun	ロードランナー	ろーどらんなー1
ldrun2	ロードランナーII - バンゲリング帝国の逆襲	ろーどらんなー2
ldrun3	ロードランナーIII - 魔神の復活	ろーどらんなー3
ldrun4	ロードランナーIV - 帝国からの脱出	ろーどらんなー4
le2	リーサルエンフォーサーズII	りーさるえんふぉーさーず2
legendos	あしたのジョー伝説 / Legend of Success Joe	あしたのじょーでんせつ
legion	超時迷宮レジオン	ちょうじめいきゅうれじおん
legionna	レジオネア	れじおねあ
lemans24	ル・マン24	るまん24
lemmings	Lemmings	れみんぐす
lethalen	リーサルエンフォーサーズ	りーさるえんふぉーさーず1
lethalth	サンダーブラスター / Lethal Thunder	さんだーぶらすたー
lghost	レーザーゴースト	れーざーごーすと
lgtnfght	トライゴン / Lightning Fighters	とらいごん
liblrabl	リブルラブル	りぶるらぶる
lifefrce	ライフフォース (US版)	らいふふぉーす_u
lifefrcej	ライフフォース (日本版)	らいふふぉーす_j
liquidk	ミズバク大冒険 / Liquid Kids	みずばくあどべんちゃー
lkage	影の伝説	かげのでんせつ
lnc	ロックンチェイス	ろっくんちぇいす
lockloadu	ガンハード / Locked 'N Loaded	がんはーど
lockon	ロックオン	ろっくおん
locomotn	ガッタンゴットン / Loco-Motion	がったんごっとん
loffire	ラインオブファイヤー - 爆弾野郎	らいんおぶふぁいやー
logicpro	ロジックプロ	ろじっくぷろ
loht	レジェンドオブヒーロー トンマ	れじぇんどおぶひーろーとんま
lomakai	魔魁伝説	まかいでんせつ
lostspc	ロストインスペース (ピンボール)	ろすといんすぺーすp
losttomb	Lost Tomb	ろすととぅーむ
lostwrld	ロストワールド (日本版) 	ろすとわーるど
lostwsga	ロストワールド・ジュラシックパーク	ろすとわーるどじゅらしっくぱーく
lotlot	ロットロット	ろっとろっと
lresort	ラストリゾート	らすとりぞーと
luckywld	ラッキー＆ワイルド	らっきーあんどわいるど
lw3_208	リーサルウェポンIII (ピンボール)	りーさるうぇぽん3
lwings	アレスの翼 / Legendary Wings	あれすのつばさ
machbrkr	マッハブレイカーズ - ニューマンアスレチック2	まっはぶれいかーず
macross2	超時空要塞マクロスII	ちょうじくうようさいまくろす2
madgear	マッドギア / Led Storm	まっどぎあ
madmotor	マッドモーター	まっどもーたー
magdrop2	マジカルドロップ2	まじかるどろっぷ2
magdrop3	マジカルドロップIII	まじかるどろっぷ3
magicbub	Magic Bubble	まじっくばぶる
maglord	マジシャンロード	まじしゃんろーど
sstriker	魔法大作戦	まほうだいさくせん
mahretsu	麻雀狂列伝 - 西日本編	まーじゃんきょうれつでん
mainevt	リングの王者 / The Main Event	りんぐのおうじゃ
majtitl2	メジャータイトル2	めじゃーたいとる2
majtitle	メジャータイトル	めじゃーたいとる1
manxtt	マンクスT.T. - スーパーバイク	まんくすてぃーてぃーすーぱーばいく
manybloc	Many Block	めにーぶろっく
mappy	マッピー	まっぴー
marble	マーブルマッドネス	まーぶるまっどねす
mars	Mars	まーず
marukin	スーパー（禁）版	すーぱーまるきんばん
marukodq	ちびまる子ちゃん まる子デラックスクイズ	ちびまるこちゃん
marvland	マーベルランド (US版)	まーべるらんど
marvlandj	マーベルランド (日本版)	まーべるらんど
masterw	マスターオブウエポン	ますたーおぶうえぽん
matchit	四川省 / Match It	しせんしょう1
matchit2	四川省II / Match It II	しせんしょう2
matrim	新豪血寺一族 闘婚 - matrimelee	しんごうけつじいちぞくとうこん
mav_402	マーベリック・ザ・ムービー (ピンボール)	まーべりっく
mazinger	マジンガーZ	まじんがーぜっと
mb_10	モンスターバッシュ (ピンボール)	もんすたーばっしゅ
mcatadv	マジカルキャットアドベンチャー	まじかるきゃっとあどべんちゃー
mdhorse	ダービークイズ マイドリームホース	だーびーくいず
mechatt	メカナイズドアタック	めかないずどあたっく
megablst	メガブラスト	めがぶらすと
megaman	ロックマン - ザ・パワーバトル	ろっくまん1
megaman2	ロックマン2 - ザ・パワーファイターズ	ろっくまん2ざぱわーふぁいたーず
meikyuh	迷宮ハンターG (日本版)	めいきゅうはんたーじい_j
mercs	戦場の狼II / Mercs	せんじょうのおおかみ2
metalb	メタルブラック	めたるぶらっく
metamrph	メタモルフィックフォース	めたもるふぃっくふぉーす
metlhawk	メタルホーク	めたるほーく
metrocrs	メトロクロス	めとろくろす
mgakuen	麻雀学園	まーじゃんがくえん1
mgakuen2	麻雀学園2	まーじゃんがくえん2
mgcldtex	マジカルデートEX	まじかるでーといーえっくす
mia	ミッシングインアクション	みっしんぐいんあくしょん
midnrun	ミッドナイトラン	みっどないとらん
midres	ミッドナイトレジスタンス (海外版)	みっどないとれじすたんす_w
midresj	ミッドナイトレジスタンス (日本版)	みっどないとれじすたんす_j
miexchng	マネーアイドルエクスチェンジャー / Money Puzzle Exhanger	まねーあいどるえくすちぇんじゃー
milln_l3	ミリオネア (L-3) (ピンボール)	みりおねあp
mimonkey	Mighty Monkey	まいてぃーもんきー
minasan	みなさんのおかげさまです！ - 大スゴロク大会	みなさんのおかげさまです
minefld	Minefield	まいんふぃーるど
mirninja	未来忍者 - 慶雲機忍外伝	みらいにんじゃ
missb2	Miss Bubble 2	みすばぶる2
mjleague	メジャーリーグ	めじゃーりーぐ
mjnquest	マージャンクエスト	まーじゃんくえすと
mk	モータルコンバット	もーたるこんばっと1
mk2	Mortal Kombat II	もーたるこんばっと2
mk3	Mortal Kombat 3 / Ultimate Mortal Kombat 3	もーたるこんばっと3
mlanding	ミッドナイトランディング	みっどないとらんでぃんぐ
mm_10	メディイーバルマッドネス (ピンボール)	めでぃいーばるまっどねす
mmancp2u	ロックマン - ザ・パワーバトル / Mega Man - The Power Battle (CPS2)	ろっくまん1_cp2_w
mmatrix	マーズマトリックス	まーずまとりっくす
mmaulers	究極戦隊ダダンダーン / Monster Maulers	きゅうきょくせんたいだだんだーん
mmaze	メルヘンメイズ	めるへんめいず
mnight	ミュータントナイト	みゅーたんとないと
mofflott	メイズオブフロット	めいずおぶふろっと
momoko	モモコ120%	ももこ120ぱーせんと
moomesa	Wild West C.O.W.-Boys of Moo Mesa	わいるどうえすとかうぼーいずおぶむーめさ
moonwar	Moonwar	むーんうぉー
mosyougi	将棋の達人 - MASTER OF SYOUGI	しょうぎのたつじん
motofren	モトフレンジー	もとふれんじー
motoraid	モーターレイド	もーたーれいど
motos	モトス	もとす
motoxgo	モトクロスゴー！	もとくろすごー
mousn_l4	マウシンアラウンド！ (LA-4) (ピンボール)	まうしんあらうんどp
mpangj	マイティ・パン	まいてぃぱん
mpatrol	ムーンパトロール	むーんぱとろーる
mrdrillr	ミスタードリラー	みすたーどりらー
mrheli	Mr.HELIの大冒険 (日本版)	みすたーへりのだいぼうけん_j
mrkougar	Mr. Kougar	みすたーくーがー
mrviking	ミスターバイキング	みすたーばいきんぐ
msh	マーヴルスーパーヒーローズ	まーぶるすーぱーひーろーず
mshvsf	マーヴルスーパーヒーローズ VS. ストリートファイター	まーぶるすーぱーひーろーずばーささすすとりーとふぁいたー
msisaac	メタルソルジャーアイザックII	めたるそるじゃーあいざっく
mslug	メタルスラッグ	めたるすらっぐ1
mslug2	メタルスラッグ2	めたるすらっぐ2
mslug3	メタルスラッグ3	めたるすらっぐ3
mslug4	メタルスラッグ4	めたるすらっぐ4
mslug5	メタルスラッグ5	めたるすらっぐ5
mslugx	メタルスラッグX	めたるすらっぐ2.5
mstadium	メインスタジアム (日本版)	めいんすたじあむ
msword	マジックソード	まじっくそーど
mtlchamp	マーシャルチャンピオン	まーしゃるちゃんぴおん
mtwins	チキチキボーイズ / Mega Twins	ちきちきぼーいず
mugsmash	Mug Smashers	まぐすまっしゃーず
mustache	マスタッシュボーイ	ますたっしゅぼーい
mustangb	US AAF ムスタング (海賊版)	ゆーえすえーえーえふむすたんぐ
mutantf	デスブレイド	ですぶれいど
mutnat	ミューテーションネーション	みゅーてーしょんねーしょん
mvp	M.V.P	えむぶいぴー
mvsc	マーヴル VS. カプコン - クラッシュオブスーパーヒーローズ	まーぶるばーさすかぷこん
mwalk	マイケルジャクソンズ ムーンウォーカー	まいけるじゃくそんずむーんうぉーかー
mx5000	フラックアタック / MX5000	ふらっくあたっく
myangel3	子育てクイズ・マイエンジェル3 - マイリトルペット	こそだてくいずまいえんじぇる3
myhero	青春スキャンダル	せいしゅんすきゃんだる
mysticri	魔法警備隊ガンホーキ / Mystic Riders	まほうけいびたいがんほーき
mystwarr	ミスティックウォリアーズ	みすてぃっくうぉりあーず
nam1975	NAM-1975	なむ1975
narc	ナーク	なーく
nastar	ラスタンサーガII	らすたんさーが2
nbaf_31	NBAファストブレイク (ピンボール)	えぬびーえーふぁすとぶれいく
nbahangt	NBA Hangtime	えぬびーえーはんぐたいむ
nbajam	NBAジャム	えぬびーえーじゃむ
nbajamte	NBA Jam Tournament Edition	えぬびーえーじゃむとーなめんとえでぃしょん
nbapbp	NBAプレイ・バイ・プレイ	えぬびーえーぷれいばいぷれい
nbbatman	野球格闘リーグマン / Ninja Baseball Batman	やきゅうかくとうりーぐまん
ncombat	ニンジャコンバット	にんじゃこんばっと
ncommand	ニンジャコマンドー	にんじゃこまんどー
ncv1	ナムコ クラシックコレクションVol.1	なむこくらしっく1
ncv2	ナムコ クラシックコレクションVol.2	なむこくらしっく2
nebulray	ネビュラスレイ	ねびゅらすれい
nemesis	グラディウス / Nemesis	ぐらでぃうす_w
nemo	ニモ	にも
neobombe	ネオボンバーマン	ねおぼんばーまん
neocup98	ネオジオカップ'98	ねおじおかっぷ98
neodrift	ネオドリフトアウト	ねおどりふとあうと
neomrdo	ネオミスターDo!	ねおみすたーどぅ
newsin7	New Sindbad 7	にゅーしんどばっどせぶん
newtangl	ニュートロピカルエンジェル	にゅーとろぴかるえんじぇる
nf_23x	ノーフィア (ピンボール)	のーふぃあ
ngg_13	ノーグッドゴーファーズ (ピンボール)	のーぐっどごーふぁーず
nightstr	ナイトストライカー	ないとすとらいかー
ninjak	ニンジャキッズ	にんじゃきっず
ninjamas	ニンジャマスターズ - 覇王忍法帖	にんじゃますたーず
ninjaw	ニンジャウォーリアーズ	にんじゃうぉーりあーず
ninjemak	妖魔忍法帖 / Ninja Emaki	ようまにんぽうちょう
nitd	ナイトメア・イン・ザ・ダーク	ないとめあいんざだーく
nitrobal	ガンボール / Nitro Ball	がんぼーる
nmg5	Multi 5 / New Multi Game 5	まるちふぁいぶ
nobb	のぼらんか	のぼらんか
nost	ノストラダムス	のすとらだむす
nrallyx	ニューラリーX	にゅーらりーえっくす
nslasher	ナイトスラッシャー	ないとすらっしゃー
nspirit	最後の忍道 / Ninja Spirit (海外版)	さいごのにんどう_w
nspiritj	最後の忍道 (日本版)	さいごのにんどう_j
numanath	ニューマンアスレチックス	にゅーまんあすれちっくす
nwarr	ヴァンパイアハンター - ダークストーカーズリベンジ	ばんぱいあはんたー
offroadc	Off Road Challenge	おふろーどちゃれんじ
offtwall	オフザウォール	おふざうぉーる
omegaf	オメガファイター	おめがふぁいたー
onna34ro	女三四郎 (set 1)	おんなさんしろう
opengolf	ゴルフィンググレイツ2 / Konami's Open Golf Championship	ごるふぃんぐぐれいつ2
openice	2 On 2 Open Ice Challenge	つーおんつーおーぷんあいすちゃれんじ
opthund	オペレーションサンダー (ピンボール)	おぺれーしょんさんだー
opwolf	オペレーションウルフ	おぺれーしょんうるふ1
opwolf3	オペレーションウルフ3	おぺれーしょんうるふ3
ordyne	オーダイン	おーだいん
orunners	アウトランナーズ	あうとらんなーず
oscar	サイコニクスオスカー	さいこにくすおすかー
othunder	オペレーションサンダーボルト	おぺれーしょんさんだーぼると
outfxies	アウトフォクシーズ	あうとふぉくしーず
outrun	アウトラン	あうとらん
outzone	アウトゾーン	あうとぞーん
overdriv	Over Drive	おーばーどらいぶ
overrev	オーバーレブ	おーばーれぶ
overtop	オーバートップ	おーばーとっぷ
p47	P-47	ぴーふぉーてぃーせぶん
p47aces	P-47 ACES	ぴーふぉーてぃーせぶんえーせず
pacapp	パカパカパッション	ぱかぱかぱっしょん1
pacapp2	パカパカパッション2	ぱかぱかぱっしょん2
pacappsp	パカパカパッション スペシャル	ぱかぱかぱっしょんすぺしゃる
pacland	パックランド	ぱっくらんど
pacman	パックマン	ぱっくまん
pacmania	パックマニア (海外版)	ぱっくまにあ_w
pacmaniaj	パックマニア (日本版)	ぱっくまにあ_j
pacnpal	パック＆パル	ぱっくあんどぱる
pacwc90	パックマン (テクモワールドカップ'90基板)	ぱっくまん_t
pairs	Pairs	ぺあーず
pang	パン	ぱん
pang3	パン3 - 怪盗たちの華麗な午後	ぱん3
panicbom	ボンバーマン ぱにっくボンバー	ぼんばーまんぱにっくぼんばー
panicr	パニックロード	ぱにっくろーど
paperboy	ペーパーボーイ	ぺーぱーぼーい
parodius	パロディウスだ！ - 神話からお笑いへ	ぱろでぃうすだ
passsht	パッシングショット	ぱっしんぐしょっと
pb_l5	ピン＊ボット (L-5) (ピンボール)	ぴんぼっとp
pbobbl2n	パズルボブル2 (ネオジオ版)	ぱずるぼぶる2ねおじお
pbobble2o	パズルボブル2	ぱずるぼぶる2
pbobble	パズルボブル	ぱずるぼぶる1
pbobble3	パズルボブル3	ぱずるぼぶる3
pbobble4	パズルボブル4	ぱずるぼぶる4
pbobblen	パズルボブル (ネオジオ版)	ぱずるぼぶる1ねおじお
pclubys	Puzzle Club (Yun Sung)	ぱずるくらぶ_y1
pdrift	パワードリフト	ぱわーどりふと
perfrman	パフォーマン	ぱふぉーまん
peterpak	ピーターパックラット	ぴーたーぱっくらっと
pgoal	フットサル	ふっとさる
phelios	フェリオス	ふぇりおす
phozon	フォゾン	ふぉぞん
pigskin	Pigskin 621AD	ぴっぐすきん
pipedrm	パイプドリーム	ぱいぷどりーむ
pipibibs	フーピー!!	ふーぴー
pistoldm	ピストル大名の冒険	ぴすとるだいみょうのぼうけん
pitfall2	ピットフォールII	ぴっとふぉーる2
pitfight	ピットファイター	ぴっとふぁいたー
pkladies	ポーカーレディース	ぽーかーれでぃーす
plsmaswd	スターグラディエイター2 / Plasma Sword	すたーぐらでぃえいたー2
pltkids	パイロットキッズ	ぱいろっときっず
plumppop	プランプポップ	ぷらんぷぽっぷ
plusalph	プラスアルファ	ぷらすあるふぁ
plygonet	ポリゴネットコマンダーズ	ぽりごねっとこまんだーず
polynetw	ポリネットウォリアーズ	ぽりねっとうぉりあーず
pnickj	ぷにっきいず	ぷにっきいず
pnyaa	ポチッとにゃ～	ぽちっとにゃー
pocketrc	ポケットレーサー	ぽけっとれーさー
polic_l4	ポリスフォース (LA-4) (ピンボール)	ぽりすふぉーすp
pontoon	ポンツーン	ぽんつーん
pool_l7	プールシャークス (L-7) (ピンボール)	ぷーるしゃくす
pooyan	プーヤン	ぷーやん
pop_lx5	ポパイ (ピンボール)	ぽぱい
popbounc	ガッポリン / Pop 'n Bounce	がっぽりん
popnpop	ぽっぷんぽっぷ	ぽっぷんぽっぷ
poundfor	パウンドフォーパウンド	ぱうんどふぉーぱうんど
pow	脱獄	だつごく
prehisle	原始島 1930's / Prehistoric Isle in 1930	げんしとう
preisle2	プレヒストリックアイル2 原始島	ぷれひすとりっくあいる2
primglex	プライムゴールEX	ぷらいむごーるいーえっくす
progear	プロギアの嵐	ぷろぎあのあらし
propcycl	プロップサイクル	ぷろっぷさいくる
pspikes2	パワースパイクスII	ぱわーすぱいくす2
psychic5	サイキック 5	さいきっくふぁいぶ
psychos	サイコソルジャー (海外版)	さいこそるじゃー_w
psychosj	サイコソルジャー (日本版)	さいこそるじゃー_j
psyforce	サイキックフォース	さいきっくふぉーす
ptblank	ガンバレット/ Point Blank	がんばれっと
ptblank2	ガンバァール / Point Blank 2 (System 12)	がんばーる_12
ptblank2ua	ガンバァール / Point Blank 2	がんばーる
puchicar	プチカラット - ジェムストーン王国の世界	ぷちからっと
pulirula	プリルラ	ぷりるら
pulstar	パルスター	ぱるすたー
punisher	パニッシャー	ぱにっしゃー
punkshot	パンクショット	ぱんくしょっと
puzlclub	パズルクラブ (プロトタイプ)	ぱずるくらぶ
puzldama	対戦ぱずるだま	たいせんぱずるだま
puzzledp	パズルdeポン！	ぱずるでぽん
pwheelsj	パワーホイールズ	ぱわーほいーるず
pwrgoal	ハットトリックヒーロー'95 / Power Goal	はっととりっくひーろー95
pzloop2	パズループ2	ぱずるーぷ2
qad	クイズ＆ドラゴンズ (海外版)	くいずあんどどらごんず_w
qadj	クイズ＆ドラゴンズ (日本版)	くいずあんどどらごんず_j
qcrayon	クイズクレヨンしんちゃん	くいずくれよんしんちゃん1
qcrayon2	クイズクレヨンしんちゃん おらと遊ぼ	くいずくれよんしんちゃん2
qgakumon	クイズ学問ノススメ	くいずがくもんのすすめ
qjinsei	クイズ人生劇場	くいずじんせいげきじょう
qndream	クイズなないろドリームス 虹色町の奇跡	くいずなないろどりーむすにじいろちょうのきせき
qsangoku	クイズ三國志 - 知略の覇者	くいずさんごくしちりゃくのはしゃ
qtono1	クイズ殿様の野望	くいずとのさまのやぼう1
qtono2j	クイズ殿様の野望2 - 全国版	くいずとのさまのやぼう2
qtorimon	苦胃頭捕物帳	くいずとりものちょう
quartet	カルテット / カルテット II	かるてっと
quester	クエスター	くえすたー
quiz18k	みやすのんきのクイズ18禁	みやすのんきのくいず18きん
quizdai2	クイズ迷探偵ネオ＆ジオ - クイズ大捜査線パート2	くいずめいたんていねおあんどじお
quizdais	クイズ大捜査線 - THE LAST COUNT DOWN	くいずだいそうさせん
quizf1	クイズF-1 ワンツーフィニッシュ	くいずえふわんわんつーふぃにっしゅ
quizhq	クイズH.Q.	くいずえいちきゅー
quizhuhu	森口博子のクイズでヒュー！ヒュー！	もりぐちひろこのくいずでひゅーひゅー
quizkof	クイズ キング・オブ・ファイターズ	くいずきんぐおぶふぁいたーず
quizmoon	クイズ!!美少女戦士セーラームーン	くいずびしょうじょせんしせーらーむーん
quiztou	熱闘！激闘！クイズ島	ねっとうげきとうくいずとう
qzchikyu	クイズ地球防衛軍	くいずちきゅうぼうえいぐん
qzquest	クイズクエスト - 姫と勇者の物語	くいずくえすと
qzshowby	クイズ世界はSHOW by ショーバイ!!	くいずせかいはしょうばいしょうばい
rab_320	ロッキー＆ブルウィンクル (ピンボール)	ろっきーあんどぶるうぃんくる
rachero	レーシングヒーロー	れーしんぐひーろー
racinfrc	レーシングフォース	れーしんぐふぉーす
racingb	レーシングビート	れーしんぐびーと
racingj	レーシングジャム	れーしんぐじゃむ1
racingj2	レーシングジャム チャプター2	れーしんぐじゃむ2
rackemup	ザ・ハスラー / Rack 'em Up	ざはすらー
radcl_l1	ラディカル (L-1) (ピンボール)	らでぃかる
radm	ラッドモビール	らっどもびーる
raflesia	ラフレシア	らふれしあ
ragnagrd	神凰拳	しんおうけん
raiden	雷電	らいでん1
raiden2	雷電 II	らいでん2
raidndx	雷電DX	らいでんでらっくす
raimais	レイメイズ	れいめいず
rainbow	レインボーアイランド	れいんぼーあいらんど
rallybik	ダッシュ野郎	だっしゅやろう
rallyx	ラリーX	らりーえっくす
rambo3p	ランボーIII	らんぼー3p
rapidrvr	ラピッドリバー	らぴっどりばー
rastan	ラスタンサーガ	らすたんさーが
raveracw	レイブレーサー	れいぶれーさー
rbff1	リアルバウト餓狼伝説 / Real Bout Fatal Fury	りあるばうとがろうでんせつ1
rbff2	リアルバウト餓狼伝説2 - THE NEWCOMERS / Real Bout Fatal Fury 2	りあるばうとがろうでんせつ2
rbffspec	リアルバウト餓狼伝説スペシャル / Real Bout Fatal Fury Special	りあるばうとがろうでんせつ1.5
rchase	レールチェイス	れーるちぇいす1
rchase2	レールチェイス2	れーるちぇいす2
rdft	ライデンファイターズ	らいでんふぁいたーず
rdkng_l4	ロードキングス (L-4) (ピンボール)	ろーどきんぐすp
realpunc	リアルパンチャー	りあるぱんちゃー
recordbr	ゴーフォーザゴールド / Recordbreaker	ごーふぉーざごーるど
regulus	レグルス	れぐるす
renegade	熱血硬派くにおくん / Renegade (US版)	ねっけつこうはくにおくん
rescu911	レスキュー911 (ピンボール)	れすきゅーないんわんわん
rescue	Rescue	れすきゅー
revx	Revolution X	れぼりゅーしょんえっくす
rfjet	ライデンファイターズJET	らいでんふぁいたーずじぇっと
ridgera2	リッジレーサー2	りっじれーさー2
ridgerac	リッジレーサー	りっじれーさー1
ridgeracf	リッジレーサーフルスケール	りっじれーさー1f
rrf	リッジレーサー (Full Scale, 1993-12-13, 海外版)	りっじれーさー1_w
ridhero	ライディングヒーロー	らいでぃんぐひーろー
ridingf	ライディングファイト	らいでぃんぐふぁいと
ringdest	スーパーマッスルボマー / Ring of Destruction	すーぱーまっするぼまー
ringrage	リングレイジ	りんぐれいじ
riot	雷軋斗	らいあっと
riotcity	ライオットシティ	らいおっとしてぃ
riskchal	ぐっすんおよよ	ぐっすんおよよ
rmpgwt	Rampage World Tour	らんぺーじわーるどつあー
roadblst	ロードブラスターズ	ろーどぶらすたーず
roadriot	Road Riot 4WD	ろーどりおっと
roadrunn	ロードランナー (アタリ版)	ろーどらんなー
roboarmy	ロボアーミー	ろぼあーみー
robocop	ロボコップ	ろぼこっぷ1
robocop2	ロボコップ2	ろぼこっぷ2
robokid	アトミックロボキッド	あとみっくろぼきっど
rockrage	恋のホットロック / Rock 'n Rage	こいのほっとろっく
rocnrope	ロックンロープ	ろっくんろーぷ
rodland	妖精物語 ロッドランド	ようせいものがたりろっどらんど
rohga	ウルフファング - 空牙2001 / Rohga Armor Force 	うるふふぁんぐ
roishtar	イシターの復活	いしたーのふっかつ
rollerg	ローラーゲームズ	ろーらーげーむず
rollr_e1	ローラーゲームズ (PU-1) (ピンボール)	ろーらーげーむずp
rollr_l2	ローラーゲームズ (L-2) (ピンボール)	ろーらーげーむず_ぴ
rompers	ロンパーズ	ろんぱーず
rotd	レイジ・オブ・ザ・ドラゴンズ	れいじおぶざどらごんず
roundup5	ラウンドアップ5 - Super Delta Force	らうんどあっぷふぁいぶ
rrreveng	Road Riot's Revenge	ろーどりおっとずりべんじ
rs_l6	レッド＆テッズロードショー (ピンボール)	れっどあんどてっずろーどしょー
rthun2	ローリングサンダー2	ろーりんぐさんだー2
rthunder	ローリングサンダー	ろーりんぐさんだー1
rtype	R-TYPE	あーるたいぷ1
rtype2	R-TYPE II	あーるたいぷ2
rtypeleo	R-TYPE LEO	あーるたいぷれお
rungun	スラムダンク	すらむだんく1
rungun2	スラムダンク2	すらむだんく2
rushcrsh	ラッシュ & クラッシュ	らっしゅあんどくらっしゅ
rushhero	ラッシングヒーローズ	らっしんぐひーろーず
rvrbt_l3	リバーボートギャンブラー (L-3) (ピンボール)	りばーぼーとぎゃんぶらー
rvschool	私立ジャスティス学園 / Rival Schools	しりつじゃすてぃすがくえん
rygar	アルゴスの戦士 / Rygar	あるごすのせんし
ryujin	龍神	りゅうじん
ryukendn	忍者龍剣伝 (日本版)	にんじゃりゅうけんでん
ryukyu	琉球	りゅうきゅう
s1945	ストライカーズ1945	すとらいかーず1945
s1945jn	ストライカーズ1945 (ガンバード基板)	すとらいかーず1945_g
s1945p	ストライカーズ1945プラス	すとらいかーず1945ぷらす
salamand	沙羅曼蛇	さらまんだ1
salmndr2	沙羅曼蛇2	さらまんだ2
samsh5sp	サムライスピリッツ零 スペシャル / Samurai Shodown V Special	さむらいすぴりっつ5sp
samsho	サムライスピリッツ / Samurai Shodown	さむらいすぴりっつ1
samsho2	真サムライスピリッツ - 覇王丸地獄変 / Samurai Shodown II	しんさむらいすぴりっつ
samsho3	サムライスピリッツ - 斬紅郎無双剣 / Samurai Shodown III	さむらいすぴりっつ3
samsho4	サムライスピリッツ - 天草降臨 / Samurai Shodown IV	さむらいすぴりっつ4
samsho5	サムライスピリッツ零 / Samurai Shodown V	さむらいすぴりっつ5
savagere	風雲黙示録 - 格闘創世 / Savage Reign	ふううんもくじろく
sbm	ソニックブラストマン	そにっくぶらすとまん
sc_18	セイフクラッカー (ピンボール)	せいふくらっかー
scfinals	ハットトリックヒーロー'93 / Super Cup Finals	はっととりっくひーろー93
schamp	ソニック・ザ・ファイターズ	そにっくざふぁいたーず
schmeisr	シュマイザーロボ	しゅまいざーろぼ
sci	S.C.I (海外版)	えすしーあい_w
scij	S.C.I (日本版)	えすしーあい_j
scobra	スーパーコブラ	すーぱーこぶら
scobras	スーパーコブラ (Stern版)	すーぱーこぶら_s
scontra	スーパー魂斗羅	すーぱーこんとら
scotrsht	スクーターシューター	すくーたーしゅーたー
scramble	スクランブル	すくらんぶる
scross	スタジアムクロス	すたじあむくろす
scud	スカッドレース	すかっどれーす
scudscsp	スカッドレース (SCSP)	すかっどれーす
sdgndmrb	SDガンダム三国志 レインボー大陸戦記	えすでぃーがんだむさんごくし
sdi	SDI	えすでぃーあい
sdodgeb	くにおの熱血闘球伝説 / Super Dodge Ball	くにおのねっけつとうきゅうでんせつ
searchar	サーチアンドレスキュー	さーちあんどれすきゅー
searchey	Search Eye	さーちあい
searchp2	Search Eye Plus V2.0	さーちあいぷらす
sectionz	セクションZ	せくしょんぜっと
seganinj	忍者プリンセス / Sega Ninja	にんじゃぷりんせす
segawski	セガウォータースキー	せがうぉーたーすきー
selfeena	セルフィーナ	せるふぃーな
sengekis	閃激ストライカー	せんげきすとらいかー
sengoku	戦国伝承 / Sengoku	せんごくでんしょう1
sengoku2	戦国伝承2 / Sengoku 2	せんごくでんしょう2
sengoku3	戦国伝承2001 Sengoku 3	せんごくでんしょう3
sexyparo	セクシーパロディウス	せくしーぱろでぃうす
sf	ストリートファイター	すとりーとふぁいたー1
sf2	ストリートファイターII - ザ・ワールドウォーリアー	すとりーとふぁいたー2
sf2ce	ストリートファイターII’-チャンピオンシップエディション	すとりーとふぁいたー2だっしゅ
sfa	ストリートファイターZERO	すとりーとふぁいたーぜろ1
sfa2	ストリートファイターZERO2	すとりーとふぁいたーぜろ2
sfa3	ストリートファイターZERO3	すとりーとふぁいたーぜろ3
sfchamp	スーパーフットボールチャンプ	すーぱーふっとぼーるちゃんぷ
sfex	ストリートファイターEX	すとりーとふぁいたーいーえっくす1
sfex2	ストリートファイターEX2	すとりーとふぁいたーいーえっくす2
sfex2p	ストリートファイターEX2プラス	すとりーとふぁいたーいーえっくす2ぷらす
sfight2	ストリートファイターII (ピンボール)	すとりーとふぁいたー2
sfposeid	シーファイターポセイドン	しーふぁいたーぽせいどん
sftm	ストリートファイター ザ・ムービー	すとりーとふぁいたーざむーびー
sfx	スペースファイターX	すぺーすふぁいたーえっくす
sfzch	ストリートファイターZERO (CPSチェンジャー版)	すとりーとふぁいたーぜろ1ちぇんじゃーばん
sgemf	ポケットファイター	ぽけっとふぁいたー
sgt24h	スーパーGT24h	すーぱーじーてぃー24
sgunner	スティールガンナー	すてぃーるがんなー1
sgunner2	スティールガンナー2	すてぃーるがんなー2
shackled	ブレイウッド	ぶれいうっど
shadfrce	シャドウフォース 変身忍者	しゃどうふぉーす
shadowld	妖怪道中記	ようかいどうちゅうき
shadoww	忍者龍剣伝 / Ninja Gaiden / Shadow Warriors (海外版)	にんじゃりゅうけんでん_w
shangon	スーパーハングオン	すーぱーはんぐおん
shaqattq	シャックアタック (ピンボール)	しゃっくあたっく
sharrier	スペースハリアー	すぺーすはりあー
shdancer	シャドーダンサー	しゃどーだんさー
shimpact	スーパーハイインパクト	すーぱーはいいんぱくと
shinobi	忍	しのび
kingdmgp	疾風魔法大作戦	しっぷうまほうだいさくせん
shocktr2	ショックトルーパーズ - セカンドスカッド	しょっくとるーぱーず2
shocktro	ショックトルーパーズ	しょっくとるーぱーず1
shollow	Satan's Hollow (set 1)	さたんずほろー
shollow2	Satan's Hollow (set 2)	さたんずほろー
shtngmst	シューティングマスター	しゅーてぃんぐますたー
shtrider	ショットライダー	しょっとらいだー
shufshot	Shuffleshot	しゃっふるしょっと
sidearms	サイドアーム - HYPER DYNE	さいどあーむ
sidebs	サイドバイサイド	さいどばいさいど1
sidebs2	サイドバイサイド2 - エボルツィオーネ	さいどばいさいど2
sidepckt	サイドポケット	さいどぽけっと
silentd	サイレントドラゴン	さいれんとどらごん
silkworm	シルクワーム	しるくわーむ
silvslug	シルバースラッガー (ピンボール)	しるばーすらっがー
simpsons	ザ・シンプソンズ	ざしんぷそんず
sjryuko	スケバン雀士竜子	すけばんじゃんしりゅうこ
skichamp	スキーチャンプ	すきーちゃんぷ
skisuprg	セガスキー スーパーG	せがすきーすーぱーじー
skullxbo	スカル & クロスボーンズ	すかるあんどくろすぼーんず
skykid	スカイキッド	すかいきっど1
skykiddx	スカイキッドDX	すかいきっど2
skyrobo	戦え！ビッグファイター / Sky Robo	たたかえびっぐふぁいたー
skysmash	スカイスマッシャー	すかいすまっしゃー
skytargt	スカイターゲット	すかいたーげっと
slammast	マッスルボマー / Saturday Night Slam Masters	まっするぼまー
alcon	スラップファイト	すらっぷふぁいと
slapshot	スラップショット	すらっぷしょっと
slrasslt	ソーラーアサルト	そーらーあさると
slyspy	シークレットエージェント	しーくれっとえーじぇんと
smashtv	スマッシュT.V.	すまっしゅてぃーびー
smb	スーパーマリオブラザーズ (ピンボール)	すーぱーまりおぶらざーず
smbmush	スーパーマリオブラザーズ マッシュルームワールド (ピンボール)	すーぱーまりおp
smgp	スーパーモナコGP	すーぱーもなこぐらんぷり
snowbros	スノーブラザーズ	すのーぶらざーず
socbrawl	サッカーブロール	さっかーぶろーる
soccerss	サッカースーパースターズ	さっかーすーぱーすたーず
solarfox	Solar Fox (効果音のみ)	そーらーふぉっくす
soldam	ソルダム	そるだむ
solfigtr	Solitary Fighter	そりたりーふぁいたー
solvalou	ソルバルウ	そるばるう
sonicbom	ソニックブーム	そにっくぶーむ
sonicwi2	ソニックウイングス2	そにっくういんぐす2
sonicwi3	ソニックウイングス3	そにっくういんぐす3
sotsugyo	卒業証書	そつぎょうしょうしょ
soulclbr	ソウルキャリバー	そうるきゃりばー
souledge1	ソウルエッジ (SO1/VER.A)	そうるえっじ1
souledge	ソウルエッジ Ver.II (SO4/VER.C)	そうるえっじ2
spacedx	スペースインベーダーDX	すぺーすいんべーだーでらっくす
spacegun	スペースガン (海外版)	すぺーすがん
spacejam	スペースジャム (ピンボール)	すぺーすじゃむ
spaceskr	スペースシーカー	すぺーすしーかー
spang	スーパーパン	すーぱーぱん
spatter	三輪サンちゃん / Spatter	さんりんさんちゃん
spcinv95	あっかんべぇだぁ～ / Space Invaders '95 - Attack Of The Lunar Loonies	あっかんべーだー
spcinvdj	スペースインベーダーDX (F3版)	すぺーすいんべーだーでらっくす
spclords	Space Lords	すぺーすろーず
spdcoin	Speed Coin (プロトタイプ)	すぴーどこいん
speedrcr	スピードレーサー (マッハGoGoGo)	すぴーどれーさー
spelunk2	スペランカー2	すぺらんかー2
spelunkr	スペランカー	すぺらんかー1
spf2t	スーパーパズルファイターII X	すーぱーぱずるふぁいたー2えっくす
spidman	スパイダーマン	すぱいだーまん
spikeofe	スパイクアウト ファイナルエディション	すぱいくあうと2
spikeout	スパイクアウト	すぱいくあうと1
spinmast	ミラクルアドベンチャー	みらくるあどべんちゃー
splatter	スプラッターハウス	すぷらったーはうす
splndrbt	スプレンダーブラスト	すぷれんだーぶらすと
spstn_l5	スペースステーション (L-5) (ピンボール)	すぺーすすてーしょん
spy	S.P.Y. - Special Project Y	すぱい
srally2	セガラリー2	せがらりー2
srallyc	セガラリーチャンピオンシップ	せがらりー1
srdarwin	スーパーリアルダーウィン	すーぱーりあるだーうぃん
srumbler	ラッシュ＆クラッシュ / The Speed Rumbler (海外版)	らっしゅあんどくらっしゅ
ss_15	スケアドスティッフ (ピンボール)	すけあどすてぃっふ
sscope	サイレントスコープ	さいれんとすこーぷ1
sscope2	サイレントスコープ2	さいれんとすこーぷ2
ssf2	スーパーストリートファイターII - ザ・ニューチャレンジャー	すーぱーすとりーとふぁいたー2
ssf2t	スーパーストリートファイターII X - グランドマスターチャレンジ	すーぱーすとりーとふぁいたー2えっくす
ssi	マジェスティックトウェルブ	まじぇすてぃっくとうぇるぶ
ssideki	得点王 / Super Sidekicks	とくてんおう1
ssideki2	得点王2 - リアルファイトフットボール / Super Sidekicks 2	とくてんおう2
ssideki3	得点王3 - 栄光への道 / Super Sidekicks 3	とくてんおう3
ssideki4	得点王 - 炎のリベロ / Ulitimate 11	とくてんおう4
ssoldier	パーフェクトソルジャーズ / Superior Soldiers	ぱーふぇくとそるじゃーず
ssprint	スーパースプリント	すーぱーすぷりんと
ssriders	サンセットライダーズ	さんせっとらいだーず
stadhero	スタジアムヒーロー	すたじあむひーろー
stagger1	ステッガー1	すてっがー1
stakwin	ステークスウィナー - GI完全制覇への道	すてーくすうぃなー1
stakwin2	ステークスウィナー2	すてーくすうぃなー2
starblad	スターブレード	すたーぶれーど
stargatp	スターゲート (ピンボール)	すたーげーと
starglad	スターグラディエイター	すたーぐらでぃえいたー
starjack	スタージャッカー	すたーじゃっかー
starswep	スタースイープ	すたーすいーぷ
startrp	スターシップトゥルーパーズ (ピンボール)	すたーしっぷとぅるーぱーず
starwars	スターウォーズ	すたーうぉーず
stcc	セガツーリングカーチャンピオンシップ	せがつーりんぐかーちゃんぴおんしっぷ
stdragon	天聖龍	せいんとどらごん
steeltal	スティールタロンズ	すてぃーるたろんず
stratgyx	ストラテジーX	すとらてじーえっくす
stratof	雷牙	らいが
streetsm	ストリートスマート	すとりーとすまーと
strhoop	ダンクドリーム	だんくどりーむ
strider	ストライダー飛竜 (set 1)	すとらいだーひりゅう1_1
strider2	ストライダー飛竜2	すとらいだーひりゅう2
striderua	ストライダー飛竜 (set 2)	すとらいだーひりゅう1_2
strkfgtr	ストライクファイター	すとらいくふぁいたー
strkforc	Strike Force	すとらいくふぉーす
sttng_l7	新スタートレック (ピンボール)	しんすたーとれっく
sttng_x7	新スタートレック (LX-7 Special) (ピンボール)	しんすたーとれっく_lx7
stunrun	スタンランナー	すたんらんなー
stwr_103	スターウォーズ (ピンボール)	すたーうぉーず
supbtime	スーパーバーガータイム	すーぱーばーがーたいむ
superbon	Super Bond	すーぱーぼんど
superchs	スーパーチェイス - クリミナルターミネーション	すーぱーちぇいす
superman	スーパーマン	すーぱーまん
superpac	スーパーパックマン	すーぱーぱっくまん
superspy	ザ・スーパースパイ	ざすーぱーすぱい
suprleag	スーパーリーグ	すーぱーりーぐ
suprloco	スーパーロコモーティブ	すーぱーろこもーてぃぶ
suprslam	スーパースラムズ - フロムTVアニメーション「スラムダンク」	すーぱーすらむず
surfnsaf	サーフンサファリ (ピンボール)	さーふんさふぁり
sutapper	タッパー (Suntory)	たっぱー
suzuk8h2	スズカエイトアワーズ2	すずかえいとあわーず2
suzuka8h	鈴鹿8アワーズ	すずかえいとあわーず1
svcpcb	SVCカオス - SNK vs Capcom	えすぶいしーかおす
swa	スターウォーズ (効果音)	すたーうぉーず
swa_dsb	スターウォーズ (BGM)	すたーうぉーず
swat	スワット	すわっと
swcourt	スーパーワールドコート	すーぱーわーるどこーと
swrds_l2	ソーズ・オブ・フューリー (L-2) (ピンボール)	そーずおぶふゅーりーp
sws2000	スーパーワールドスタジアム2000	すーぱーわーるどすたじあむ2000
sws92	スーパーワールドスタジアム'92	すーぱーわーるどすたじあむ1992
sws95	スーパーワールドスタジアム'95-'97	すーぱーわーるどすたじあむ1995
sws99	スーパーワールドスタジアム'99	すーぱーわーるどすたじあむ1999
swtmpeg	スターウォーズトリロジーアーケード (BGM)	すたーうぉーずとりろじー
swtril43	スターウォーズトリロジー - スペシャルエディション (ピンボール)	すたーうぉーずとりろじーすぺ
syvalion	サイバリオン	さいばりおん
tactcian	タクティシャン	たくてぃしゃん
taf_l5	アダムスファミリー (L-5) (ピンボール)	あだむすふぁみりーp
tafg_lx3	アダムスファミリー スペシャルコレクターズエディションゴールド (LX-3) (ピンボール)	あだむすふぁみりーすぺしゃるp
tail2nos	スーパーフォーミュラ - 地上最速のバトル	すーぱーふぉーみゅら
tankfrce	タンクフォース	たんくふぉーす
taotaido	タオ体道	たおたいどう
tapper	タッパー (Budweiser)	たっぱー
tattass	タトゥーアサシン (ピンボール)	たとぅーあさしん
taxi_l4	タクシー (Lola) (L-4) (ピンボール)	たくしーp
tazmania	Tazz-Mania (set 1)	たすまにあ
tbyahhoo	ツインビーヤッホー！	ついんびーやっほー
tceptor2	3DサンダーセプターII (WSGのみ)	すりーでぃーさんだーせぷたー2
tcobra2	究極タイガーII / Twin Cobra 2	きゅうきょくたいがー2
tdfever	タッチダウンフィーバー (海外版)	たっちだうんふぃーばー_w
tdfeverj	タッチダウンフィーバー (日本版)	たっちだうんふぃーばー_j
tdragon2	サンダードラゴン2	さんだーどらごん2
techromn	超鋼戦紀キカイオー / Tech Romancer	ちょうこうせんききかいおー
teddybb	テディーボーイ・ブルース	てでぃーぼーいぶるーす
teedoffp	ティードオフ (ピンボール)	てぃーどおふ
tekken	鉄拳	てっけん1
tekken2	鉄拳2	てっけん2
tekken3	鉄拳3	てっけん3
tektagt	鉄拳タッグトーナメント	てっけんたっぐとーなめんと
tengai	戦国ブレード	せんごくぶれーど
tenkomor	てんこもりシューティング	てんこもりしゅーてぃんぐ
terabrst	テラバースト	てらばーすと
term2	ターミネーター2	たーみねーたー2
terracren	テラクレスタ (OPN版)	てらくれすた
terracrea	テラクレスタ (OPL版 2)	てらくれすた
terracre	テラクレスタ (OPL版 1)	てらくれすた
terraf	テラフォース	てらふぉーす
tetris	テトリス (セガ)	てとりす
tetrisp	テトリスプラス	てとりすぷらす
tetrisp2	テトリスプラス2	てとりすぷらす2
tetrist	テトリス (B-System, YM2610)	てとりすb2610
tetrista	テトリス (B-System, YM2203)	てとりすb2203
tfight	タイトルファイト (ピンボール)	たいとるふぁいと
tftc_303	テイルズ・フロム・ザ・クリプト (ピンボール)	ているずふろむざくりぷと
tgmj	テトリス ザ・グランドマスター	てとりすざぐらんどますたー
tharrier	タスクフォースハリアー	たすくふぉーすはりあー
theend	ジ・エンド	じえんど
thunderxa	サンダークロス (日本版)	さんだーくろす1_j
thndrbld	サンダーブレード	さんだーぶれーど
thndrx2	サンダークロスII	さんだーくろす2
thndzone	サンダーゾーン / Desert Assault	さんだーぞーん
thrilld	スリルドライブ	すりるどらいぶ
thunderh	オペレーションサンダーハリケーン	おぺれーしょんさんだーはりけーん
thunderj	ThunderJaws	さんだーじょーず
thunderx	サンダークロス (海外版)	さんだーくろす1_w
thundfox	サンダーフォックス	さんだーふぉっくす
tigerh	タイガーヘリ	たいがーへり
tigeroad	虎への道 / Tiger Road (海外版)	とらへのみち_w
timber	ティンバー	てぃんばー
timecris	タイムクライシス	たいむくらいしす1
timecrs2	タイムクライシス2	たいむくらいしす2
timekill	Time Killers	たいむきらーず
timeplt	タイムパイロット	たいむぱいろっと
timescan	タイムスキャナー	たいむすきゃなー
timetunl	タイムトンネル	たいむとんねる
tinklpit	ティンクルピット	てぃんくるぴっと
tinstar	ティンスター	てぃんすたー
titanic	タイタニック (メダル機)	たいたにっく
titlef	タイトルファイト	たいとるふぁいと
tkdensho	闘姫伝承 - エンジェルアイズ	とうきでんしょう
tkmmpzdm	ときめきメモリアル 対戦ぱずるだま	ときめきめもりあるたいせんぱずるだま
tmnt	T.M.N.T. - スーパー亀忍者	てぃーえむえぬてぃー1
tmnt2	T.M.N.T. - Turtles in Time	てぃーえむえぬてぃー2
tnzsjo	ザ・ニュージーランドストーリー	ざにゅーじーらんどすとーりー
todruaga	ドルアーガの塔	どるあーがのとう
toki	JuJu伝説 / Toki	じゅじゅでんせつ
tokio	スクランブルフォーメーション	すくらんぶるふぉーめーしょん
tokisens	時の戦士	ときのせんし
tokkae	対戦とっかえだま	たいせんとっかえだま
tom_13	シアター・オブ・マジック (ピンボール)	しあたーおぶまじっく
tomy_400	トミー・ピンボールウィザード	とみーぴんぼーるうぃざーど
toobin	ツービン	つーびん
tophuntr	トップハンター	とっぷはんたー
topland	トップランディング	とっぷらんでぃんぐ
topskatr	トップスケーター	とっぷすけーたー
topspeed	フルスロットル	ふるすろっとる
toramich	虎への道 (日本版)	とらへのみち_j
toryumon	登龍門	とうりゅうもん
totan_14	テイルズ・オブ・ジ・アラビアンナイト (ピンボール)	ているずおぶじあらびあんないと
totcarn	Total Carnage	とーたるかーねいじ
totmejan	とってもE雀	とってもいーじゃん
toukon3	新日本プロレスリング 闘魂烈伝3 - アーケードエディション	しんにほんぷろれすりんぐとうこんれつでん3
toutrun	ターボアウトラン	たーぼあうとらん
toypop	トイポップ	といぽっぷ
tp2m32	テトリスプラス2 (MegaSystem 32 Version)	てとりすぷらす2
tpgolf	トッププレイヤーズゴルフ	とっぷぷれいやーずごるふ
trally	スラッシュラリー	すらっしゅらりー
travrusa	ジッピーレース / Traverse USA	じっぴーれーす
trek_201	スタートレック 25周年記念 (ピンボール)	すたーとれっく
triothep	トリオ・ザ・パンチ	とりおざぱんち
trisport	Tri-Sports	とらいすぽーつ
trog	Trog	とろーぐ
trojan	闘いの挽歌 / Trojan	たたかいのばんか
tron	トロン	とろん
trstar	トップランキングスターズ	とっぷらんきんぐすたーず
trucksp3	トラックストップ (P-3) (ピンボール)	とらっくすとっぷp
truxton	達人 / Truxton	たつじん
ts_lx5	ザ・シャドウ (ピンボール)	ざしゃどう
ts2	闘神伝2	とうしんでん2
tshingen	武田信玄	たけだしんげん
tsptr_l3	トランスポーター・ザ・レスキュー (L-3) (ピンボール)	とらんすぽーたーざれすきゅーp
ttt_10	Ticket Tac Toe (redemption)	てぃけっとたくとぅー
tturfu	タフターフ	たふたーふ
tumblep	タンブルポップ	たんぶるぽっぷ
turfmast	ビッグトーナメントゴルフ / Neo Turf Masters	びっぐとーなめんとごるふ
turtles	ターピン / Turtles	たーぴん
turtship	タートルシップ	たーとるしっぷ
tutankhm	ツタンカーム	つたんかーむ
twinbee	ツインビー	ついんびー
twincobr	究極タイガー / Twin Cobra	きゅうきょくたいがー
twinhawk	大旋風 / Twin Hawk	だいせんぷう
twinqix	ついんくいっくす	ついんくいっくす
twinspri	ティンクルスタースプライツ	てぃんくるすたーすぷらいつ
twotiger	Two Tigers (効果音のみ)	つーたいがーず
twotigerc	Two Tigers (Tron Conversion) (効果音のみ)	つーたいがーず
twrldc94	テクモワールドカップ '94	てくもわーるどかっぷ94
tws96	テクモワールドサッカー '96	てくもわーるどさっかー96
twst_405	ツイスター (ピンボール)	ついすたー
tz_92	トワイライトゾーン (ピンボール, ver 9.2)	とわいらいとぞーん
uballoon	Ultra Balloon	うるとらばるーん
uccops	アンダーカバーコップス (海外版)	あんだーかばーこっぷす_w
uccopsj	アンダーカバーコップス (日本版)	あんだーかばーこっぷす_j
ufosensi	UFO戦士ようこちゃん	ゆーふぉーせんしようこちゃん
undrfire	アンダーファイアー	あんだーふぁいあー
unsquad	エリア88 / U.N. Squadron	えりあえいてぃーえいと
uopoko	魚ポコ	うおぽこ
upndown	アップンダウン	あっぷんだうん
valkyrie	ワルキューレの伝説	わるきゅーれのでんせつ
valtric	バルトリック	ばるとりっく
vaportra	空牙 / Vapor Trail	くうが
varth	バース	ばーす
vball	V'ボール	ぶいぼーる
vcop	バーチャコップ	ばーちゃこっぷ1
vcop2	バーチャコップ2	ばーちゃこっぷ2
vegas	ベガス (ピンボール)	べがす
vendetta	クライムファイターズ2	くらいむふぁいたーず2
vf	バーチャファイター	ばーちゃふぁいたー1
vf2	バーチャファイター2	ばーちゃふぁいたー2
vf3	バーチャファイター3	ばーちゃふぁいたー3
vgoalsoc	テクモVゴールサッカー	てくもぶいごーるさっかー
vhunt2	ヴァンパイアハンター2 - ダークストーカーズリベンジ	ばんぱいあはんたー2
victlapw	エースドライバー - ビクトリーラップ	えーすどらいばーびくとりーらっぷ
victnine	ビクトリアスナイン	びくとりあすないん
victroad	怒号層圏 / Victory Road (海外版)	どごうそうけん_w
viewpoin	ビューポイント	びゅーぽいんと
vigilant	ビジランテ	びじらんて
vindctr2	Vindicators Part II	びんじけーたーず2
vindictr	ビンジケーターズ	びんじけーたーず1
viofight	バイオレンスファイト	ばいおれんすふぁいと
viostorm	バイオレントストーム	ばいおれんとすとーむ
viprp1	バイパーフェイズ1 (海外版)	ばいぱーふぇいずわんw
viprp1j	バイパーフェイズ1 (日本版)	ばいぱーふぇいずわん
viprsega	バイパーナイトドライビン (ピンボール)	ばいぱーないとどらいびんp
vliner	V-Liner	ぶいらいなー
volfied	ヴォルフィード	ぼるふぃーど
von	電脳戦機バーチャロン	でんのうせんきばーちゃろん1
von2	電脳戦機バーチャロン - オラトリオ・タングラム	でんのうせんきばーちゃろん2
vr	バーチャレーシング	ばーちゃれーしんぐ
vs2	バーチャストライカー2	ばーちゃすとらいかー2
vs298	バーチャストライカー2 バージョン'98	ばーちゃすとらいかー2ばーじょん98
vs2v991	バーチャストライカー2 バージョン'99	ばーちゃすとらいかー2ばーじょん99
vsav	ヴァンパイアセイヴァー - ザ・ロードオブヴァンパイア	ばんぱいあせいばー1
vsav2	ヴァンパイアセイヴァー2 - ザ・ロードオブヴァンパイア	ばんぱいあせいばー2
vshoot	Jリーグサッカー Vシュート	じぇいりーぐさっかーぶいしゅーと
vsnetscr	ヴァーサスネットサッカー	ばーさすねっとさっかー
vstriker	バーチャストライカー	ばーちゃすとらいかー
vulcan	グラディウスII - GOFERの野望	ぐらでぃうす2
wacko	Wacko (効果音のみ)	わっこー
wakuwak7	わくわく7	わくわくせぶん
wardner	ワードナの森	わーどなのもり
warriorb	ウォリアーブレード - ラスタンサーガエピソード III	うぉーりあーぶれーど
waterski	ウォータースキー	うぉーたーすきー
waterwld	ウォーターワールド (ピンボール)	うぉーたーわーるど
waverunr	ウェーブランナー	うえーぶらんなー
wb3	ワンダーボーイIII モンスターレア	わんだーぼーい3
wbml	ワンダーボーイ モンスターランド	わんだーぼーいもんすたーらんど
wboy	ワンダーボーイ	わんだーぼーい1
wc90	テクモワールドカップ '90	てくもわーるどかっぷ90
wcbowl	World Class Bowling	わーるどくらすぼうりんぐ
wcs_l2	ワールドカップ '94 (ピンボール)	わーるどかっぷ94
wcsoccer	ワールドチャレンジサッカー (ピンボール)	わーるどちゃれんじさっかー
wd_12	フー・ダニット (ピンボール)	ふーだにっと
wecleman	ウェック・ル・マン24	うぇっくるまん24
welltris	ウェルトリス	うぇるとりす
wgp	WGP - ワールドグランプリ	わーるどぐらんぷり1
wgp2	WGP2 - ワールドグランプリ2	わーるどぐらんぷり2
wh1	ワールドヒーローズ	わーるどひーろーず1
wh2	ワールドヒーローズ2	わーるどひーろーず2
wh2j	ワールドヒーローズ2 JET	わーるどひーろーず2じぇっと
whirl_l3	ワールウィンド (L-3) (ピンボール)	わーるうぃんどp
whp	ワールドヒーローズパーフェクト	わーるどひーろーずぱーふぇくと
wildfang	ワイルドファング / Tecmo Knight	わいるどふぁんぐ
willow	ウィロー	うぃろー
windheat	ワインディングヒート	わいんでぃんぐひーと
wingwar	ウィングウォー (R360版)	うぃんぐうぉー
winrun	ウイニングラン 鈴鹿GP	ういにんぐらんすずか
winrun91	ウイニングラン '91	ういにんぐらん91
winspike	ウイニングスパイク	ういにんぐすぱいく
wipeout	ワイプアウト (ピンボール)	わいぷあうと
wizdfire	ダークシールII / Wizard's Fire	だーくしーる2
wjammers	フライングパワーディスク / Windjammers	ふらいんぐぱわーでぃすく
wldcourt	プロテニス・ワールドコート	ぷろてにすわーるどこーと
wmatch	ウォーターマッチ	うぉーたーまっち
wndrmomo	ワンダーモモ	わんだーもも
wndrplnt	ワンダープラネット	わんだーぷらねっと
wof	天地を喰らうII - 赤壁の戦い / Warriors of Fate (海外版)	てんちをくらう2_w
wondstck	Wonder Stick	わんだーすてぃっく
worldwar	ワールドウォーズ	わーるどうぉーず
wpksoc	ワールドPKサッカー	わーるどぴーけーさっかー
wrestwar	レッスルウォー	れっするうぉー
ws	プロ野球 ワールドスタジアム	ぷろやきゅうわーるどすたじあむ
ws89	プロ野球 ワールドスタジアム '89	ぷろやきゅうわーるどすたじあむ89
wwallyj	ウォーリーを探せ！	うぉーりーをさがせ
wwestern	ワイルドウエスタン	わいるどうえすたん
wwfmania	WWF Wrestlemania	だぶりゅーだぶりゅーえふれっするまにあ
wwfr_106	WWFロイヤルランブル (ピンボール)	だぶりゅーだぶりゅーえふろいらるらんぶる
wwfsstar	WWFスーパースターズ	だぶりゅーだぶりゅーえふすーぱーすたーず
wwfwfest	WWFレッスルフェスト	だぶりゅーだぶりゅーえふれっするふぇすと
xday2	X-DAY2	えっくすでい2
xevi3dg	ゼビウス 3D/G	ぜびうす3D/G
xevious	ゼビウス	ぜびうす
xexex	ゼクセクス	ぜくせくす
xfilepin	X-ファイル (ピンボール)	えっくすふぁいる
xmcota	エックスメン - チルドレンオブジアトム	えっくすめんちるどれんおぶじあとむ
xmen	X-MEN	えっくすめん
xmultipl	エックスマルチプライ	えっくすまるちぷらい
xmultiplm72	エックスマルチプライ (M72版)	えっくすまるちぷらい_72
xmvsf	エックスメン VS. ストリートファイター	えっくすめんばーさすすとりーとふぁいたー
xsedae	X Se Dae Quiz	えっくすせでくいず
xsleena	ザインドスリーナ	ざいんどすりーな
xybots	ザイボット	ざいぼっと
yesnoj	YES.NO 心理トキメキチャート	いえすのーしんりときめきちゃーと
youjyudn	妖獣伝	ようじゅうでん
yuyugogo	ゆうゆのクイズでGo！Go！	ゆうゆのくいずでごーごー
zedblade	オペレーションラグナロク / Zed Blade	おぺれーしょんらぐなろく
zerogun	ゼロガンナー	ぜろがんなー
zeroteam	ゼロチーム	ぜろちーむ
zerowing	ゼロウイング	ぜろういんぐ
zintrckb	押し出しジントリック	おしだしじんとりっく
zupapa	ズパパ!!	ずぱぱ

aquajet	アクアジェット	あくあじぇっと
bingoc	ビンゴサーカス (メダル)	びんごさーかす
hvyunit	ヘビーユニット	へびーゆにっと
nob	のぼらんか	のぼらんか
panicprk	パニックパーク	ぱにっくぱーく
strax_p7	スタートラックス (domestic prototype) (ピンボール)	すたーとらっくす
tokyowar	トーキョーウォーズ	とーきょーうぉーず
magtruck	マジカルトロッコアドベンチャー	まじかるとろっこあどべんちゃー
hangplt	ハングパイロット	はんぐぱいろっと
dirtdash	ダートダッシュ	だーとだっしゅ
ctrpllrp	Caterpillar (パックマンハック版)	きゃたぴら
joyman	Joyman	じょいまん
nrallyxb	ニューラリーX (海賊版?)	にゅーらりーえっくす-b
grainbow	SDガンダム三国志 レインボー大陸戦記	えすでぃーがんだむさんごくし
finlflng	ファイナルハロン	ふぁいなるはろん
cnbe	Codename: Blut Engel	こーどねーむぶらっどえんじぇる
lamachin	L.A.マシンガンズ	えるえーましんがんず
mac_zois	マシナ・ゾイス バーチャルトレーニングセンター (ピンボール)	ましなぞいす
wd_12g	フー・ダニット (1.2 ドイツ版) (ピンボール)	ふーだにっと_12
monopred	モノポリー (メダル機)	ものぽりー_m
wackadoo	Wack-A-Doodle-Doo (Redemption)	わっかどーどぅるどぅー
oceanhun	オーシャンハンター	おーしゃんはんたー
waveshrk	ジェットウェーブ / Wave Shark	じぇっとうぇーぶ
gunwars	ガンメンウォーズ	がんめんうぉーず
downhill	ダウンヒルバイカーズ	だうんひるばいかーず
crszone	クライシスゾーン	くらいしすぞーん
chkun	チャンス君	ちゃんすくん
alcon	スラップファイト / Alcon	すらっぷふぁいと
bygone	Bygone	ばいごーん
rumba	ルンバランバ	るんばらんば
atlantip	アトランティス (ピンボール)	あとらんてぃす
xfilesp	Xファイル	えっくすふぁいる
ctcheese	Cut The Cheese (Redemption)	かっとざちーず
